station_id;name;numbikesavailable;mechanical;ebike;numdocksavailable;timestamp;date;hour;weekday
16107;Benjamin Godard - Victor Hugo;18;5;13;17;2025-06-05 00:59:47;2025-06-05;0;Thursday
40001;Hôpital Mondor;8;4;4;19;2025-06-05 01:02:42;2025-06-05;1;Thursday
44015;Rouget de L'isle - Watteau;18;4;14;2;2025-06-05 01:02:36;2025-06-05;1;Thursday
9020;Toudouze - Clauzel;0;0;0;21;2025-06-05 00:54:41;2025-06-05;0;Thursday
14014;Jourdan - Stade Charléty;15;8;7;43;2025-06-05 01:00:21;2025-06-05;1;Thursday
32017;Basilique;6;3;3;16;2025-06-05 01:02:32;2025-06-05;1;Thursday
11104;Charonne - Robert et Sonia Delaunay;12;7;5;8;2025-06-05 01:01:44;2025-06-05;1;Thursday
8026;Messine - Place Du Pérou;2;1;1;10;2025-06-05 00:52:53;2025-06-05;0;Thursday
13007;Le Brun - Gobelins;33;27;6;13;2025-06-05 01:02:18;2025-06-05;1;Thursday
6003;Saint-Sulpice;1;1;0;18;2025-06-05 01:03:03;2025-06-05;1;Thursday
7002;Vaneau - Sèvres;8;4;4;25;2025-06-05 01:01:37;2025-06-05;1;Thursday
6108;Saint-Romain - Cherche-Midi;2;1;1;14;2025-06-05 00:58:39;2025-06-05;0;Thursday
42016;Pierre et Marie Curie - Maurice Thorez;19;9;10;8;2025-06-05 00:58:13;2025-06-05;0;Thursday
40011;Bas du Mont-Mesly;24;16;8;3;2025-06-05 01:00:31;2025-06-05;1;Thursday
25006;Place Nelson Mandela;4;0;4;17;2025-06-05 00:56:58;2025-06-05;0;Thursday
32304;Charcot - Benfleet;5;0;5;23;2025-06-05 00:57:30;2025-06-05;0;Thursday
11025;Froment - Bréguet;14;11;3;28;2025-06-05 01:03:14;2025-06-05;1;Thursday
6021;Beaux-Arts - Bonaparte;2;0;2;18;2025-06-05 00:53:35;2025-06-05;0;Thursday
15202;Bracion - Périphérique;4;0;4;25;2025-06-05 01:01:51;2025-06-05;1;Thursday
12109;Mairie du 12ème;29;26;3;0;2025-06-05 01:03:34;2025-06-05;1;Thursday
8050;Boétie - Ponthieu;0;0;0;43;2025-06-05 01:00:56;2025-06-05;1;Thursday
13101;Croulebarde - Corvisart;31;29;2;2;2025-06-05 01:03:32;2025-06-05;1;Thursday
31024;Romainville - Vaillant-Couturier;7;2;5;31;2025-06-05 01:03:23;2025-06-05;1;Thursday
40016;Sarrazins - Saussure;0;0;0;22;2025-02-05 10:35:03;2025-02-05;10;Wednesday
2022;Saint-Fiacre - Poissonière;5;3;2;29;2025-06-05 01:02:31;2025-06-05;1;Thursday
17025;Chazelles - Courcelles;0;0;0;34;2025-06-05 00:59:29;2025-06-05;0;Thursday
21326;Moulin de Pierre - Abbé Grégoire;14;5;9;6;2025-06-05 00:59:42;2025-06-05;0;Thursday
20143;Ramponeau - Belleville;14;13;1;29;2025-06-05 01:02:31;2025-06-05;1;Thursday
21216;Louis Lejeune - Barbès;3;2;1;22;2025-06-05 00:56:50;2025-06-05;0;Thursday
22207;Rond-point du Dr Albert Schweitzer;11;6;5;11;2025-06-05 00:56:41;2025-06-05;0;Thursday
92002;Théâtre des Amandiers - Palais des sports;3;1;2;19;2025-06-05 00:59:45;2025-06-05;0;Thursday
31028;Raspail Barbès;12;1;11;16;2025-06-05 01:00:50;2025-06-05;1;Thursday
44017;Jules Guesde - Pont du Port à l'Anglais;25;22;3;3;2025-06-05 01:02:59;2025-06-05;1;Thursday
44010;8 Mai 1945 - 10 Juillet 1940;29;19;10;1;2025-06-05 01:01:12;2025-06-05;1;Thursday
16118;Michel-Ange - Parent de Rosan;13;11;2;12;2025-06-05 00:58:43;2025-06-05;0;Thursday
9008;Tour d'Auvergne - Rodier;7;5;2;9;2025-06-05 00:59:21;2025-06-05;0;Thursday
8048;Marceau - Chaillot;1;0;1;18;2025-06-05 01:01:56;2025-06-05;1;Thursday
14013;Liard - Amiral Mouchez;25;17;8;2;2025-06-05 01:02:49;2025-06-05;1;Thursday
15112;Vigée-Lebrun - Anselme Payen;8;0;8;16;2025-06-05 01:02:30;2025-06-05;1;Thursday
13030;Italie - Tolbiac;6;1;5;13;2025-06-05 01:00:29;2025-06-05;1;Thursday
19027;Serrurier;0;0;0;0;2025-05-21 06:48:59;2025-05-21;6;Wednesday
18111;Félix Ziem - Armand Gauthier;3;2;1;21;2025-06-05 00:56:12;2025-06-05;0;Thursday
43009;Place Jean-Spire-Lemaître;45;26;19;2;2025-06-05 01:03:24;2025-06-05;1;Thursday
10115;Granges aux Belles;6;4;2;21;2025-06-05 01:03:17;2025-06-05;1;Thursday
10161;Gare de l'Est - Faubourg-Saint-Martin;3;0;3;29;2025-06-05 00:58:04;2025-06-05;0;Thursday
41303;Gare de Nogent-le-Perreux;28;22;6;2;2025-06-05 01:03:03;2025-06-05;1;Thursday
12031;Gabriel Lamé;27;26;1;6;2025-06-05 01:03:25;2025-06-05;1;Thursday
1001;Quai de l'Horloge - Pont Neuf;2;0;2;15;2025-06-05 01:02:29;2025-06-05;1;Thursday
5022;Boulangers - Cardinal Lemoine;1;1;0;19;2025-06-05 00:54:52;2025-06-05;0;Thursday
21328;Verger - Colonel Guichard;5;0;5;24;2025-06-05 00:58:51;2025-06-05;0;Thursday
13104;Gare d'Austerlitz - Quai Saint-Bernard;0;0;0;27;2025-06-05 01:02:59;2025-06-05;1;Thursday
8009;Gare Saint-Lazare - Isly;0;0;0;26;2025-06-05 00:58:12;2025-06-05;0;Thursday
31103;Gare Rosny-Bois-Perrier;13;4;9;21;2025-06-05 00:55:29;2025-06-05;0;Thursday
5005;Gay Lussac - Saint-Jacques;0;0;0;24;2025-06-05 00:56:37;2025-06-05;0;Thursday
21323;Charlot - Stade Gabriel Voisin;22;21;1;7;2025-06-05 01:01:42;2025-06-05;1;Thursday
8053;Place Georges Guillaumin;1;1;0;28;2025-06-05 00:54:21;2025-06-05;0;Thursday
31706;Château - République;6;2;4;18;2025-06-05 00:54:35;2025-06-05;0;Thursday
22409;Henri Barbusse - Stalingrad;11;2;9;3;2025-06-05 00:56:33;2025-06-05;0;Thursday
19003;Quai de la Seine;3;1;2;19;2025-06-05 01:02:00;2025-06-05;1;Thursday
5020;Institut du Monde Arabe - Saint-Germain;4;1;3;36;2025-06-05 01:00:08;2025-06-05;1;Thursday
92007;Pesaro - Préfecture;5;0;5;17;2025-06-05 01:02:57;2025-06-05;1;Thursday
26002;Redoute - Les Courtilles;35;26;9;2;2025-06-05 01:03:15;2025-06-05;1;Thursday
17043;Belidor - Gouvion-Saint-Cyr;4;2;2;35;2025-06-05 01:00:25;2025-06-05;1;Thursday
19026;Place de Rhin et Danube;9;1;8;6;2025-06-05 01:03:26;2025-06-05;1;Thursday
16039;Exelmans - Versailles;16;15;1;32;2025-06-05 01:00:04;2025-06-05;1;Thursday
11023;Saint-Maur - Roquette;43;40;3;0;2025-06-05 01:02:28;2025-06-05;1;Thursday
8034;Berri - Haussmann;2;2;0;32;2025-06-05 01:02:45;2025-06-05;1;Thursday
11047;Amelot - Saint-Sébastien;21;19;2;7;2025-06-05 00:58:35;2025-06-05;0;Thursday
18107;Chartres - La Charbonnière;6;2;4;27;2025-06-05 01:02:29;2025-06-05;1;Thursday
20042;Pyrénées - Emmery;11;1;10;29;2025-06-05 01:02:59;2025-06-05;1;Thursday
15067;Desaix - Edgar Faure;6;5;1;5;2025-06-05 00:59:49;2025-06-05;0;Thursday
17030;Pereire - Rennequin;7;7;0;15;2025-06-05 01:00:43;2025-06-05;1;Thursday
6006;Notre-Dame-des-Champs - Stanislas;2;0;2;17;2025-06-05 01:00:12;2025-06-05;1;Thursday
11027;Saint-Ambroise - Parmentier;21;18;3;17;2025-06-05 00:57:54;2025-06-05;0;Thursday
8010;Liège - Moscou;2;1;1;15;2025-06-05 00:56:34;2025-06-05;0;Thursday
46002;Rouget de Lisle;18;10;8;17;2025-06-05 01:03:06;2025-06-05;1;Thursday
33102;Gabriel Péri - Francisco Ferrer;16;10;6;1;2025-06-05 00:58:05;2025-06-05;0;Thursday
42706;Roger Salengro - Fontainebleau;4;4;0;19;2025-06-05 00:58:29;2025-06-05;0;Thursday
18003;Cimetière de Montmartre;4;1;3;39;2025-06-05 00:56:01;2025-06-05;0;Thursday
11113;Richard Lenoir - Republique;16;16;0;42;2025-06-05 01:03:33;2025-06-05;1;Thursday
14003;Schoelcher - Raspail;5;2;3;45;2025-06-05 00:55:11;2025-06-05;0;Thursday
43008;Fontenay - Libération;21;13;8;4;2025-06-05 00:55:52;2025-06-05;0;Thursday
5018;Mutualité;4;2;2;29;2025-06-05 00:57:41;2025-06-05;0;Thursday
14138;Porte de Vanves;7;2;5;23;2025-06-05 01:01:41;2025-06-05;1;Thursday
12114;Victor Hugo - Jeanne Jugan;13;7;6;14;2025-06-05 01:03:10;2025-06-05;1;Thursday
14008;Mouton Duvernet - Général Leclerc;15;5;10;13;2025-06-05 01:02:38;2025-06-05;1;Thursday
13001;Port-Royal - Hôpital du Val-de-Grâce;17;13;4;1;2025-06-05 01:01:34;2025-06-05;1;Thursday
18028;Championnet - Vauvenargues;25;15;10;6;2025-06-05 01:03:10;2025-06-05;1;Thursday
35010;Hoche - Jean Lolive;1;1;0;23;2025-06-05 01:03:31;2025-06-05;1;Thursday
15106;Grenelle - Violet;20;18;2;13;2025-06-05 01:01:29;2025-06-05;1;Thursday
5124;Erasme - Ulm;3;0;3;21;2025-06-05 01:02:47;2025-06-05;1;Thursday
14106;Marc Sangnier - Porte de Vanves;12;2;10;9;2025-06-05 01:03:34;2025-06-05;1;Thursday
18046;Etienne Jodelle - Saint Ouen;1;0;1;32;2025-06-05 00:54:21;2025-06-05;0;Thursday
18022;Marcadet - Barbès;25;11;14;11;2025-06-05 01:03:32;2025-06-05;1;Thursday
8054;Bertie Albrecht - Hoche;0;0;0;32;2025-06-05 01:03:27;2025-06-05;1;Thursday
15109;Cevennes - Bergers;28;26;2;1;2025-06-05 01:03:22;2025-06-05;1;Thursday
14012;Sibelle - Alésia;16;11;5;21;2025-06-05 01:01:10;2025-06-05;1;Thursday
10042;Enghien - Faubourg Poissonnière;2;1;1;30;2025-06-05 01:03:28;2025-06-05;1;Thursday
19103;Manin - Carrières d'Amérique;15;7;8;2;2025-06-05 01:02:47;2025-06-05;1;Thursday
17203;Place de la Porte de Champeret;10;7;3;16;2025-06-05 01:02:06;2025-06-05;1;Thursday
42014;Place Marcel Cachin;32;24;8;0;2025-06-05 01:02:06;2025-06-05;1;Thursday
46003;Conservatoire de Musique;0;0;0;25;2025-06-05 00:57:13;2025-06-05;0;Thursday
16202;Commandant Schloesing - Pétrarque;0;0;0;30;2025-05-23 15:36:48;2025-05-23;15;Friday
44013;Edouard Tremblay - Julian Grimaux;16;9;7;11;2025-06-05 01:00:05;2025-06-05;1;Thursday
21015;Nationale - Place Jules Guesde;22;21;1;1;2025-06-05 01:00:46;2025-06-05;1;Thursday
15034;Lakanal - Commerce;47;43;4;1;2025-06-05 01:02:56;2025-06-05;1;Thursday
5028;Censier - Jardin des Plantes;23;22;1;4;2025-06-05 01:00:09;2025-06-05;1;Thursday
22203;Tertres - Fontaine;23;9;14;5;2025-06-05 01:01:46;2025-06-05;1;Thursday
1119;Cossonnerie - Sébastopol;5;1;4;19;2025-06-05 01:02:32;2025-06-05;1;Thursday
1020;Cambon - Rivoli;3;0;3;34;2025-06-05 01:03:09;2025-06-05;1;Thursday
25003;Henri Ste-Claire Déville - Paul Héroult;4;4;0;19;2025-06-05 00:54:38;2025-06-05;0;Thursday
31003;Paris - Emile Zola;19;10;9;11;2025-06-05 01:01:58;2025-06-05;1;Thursday
9116;Victoire - Chaussée d'Antin;1;0;1;21;2025-06-05 00:56:36;2025-06-05;0;Thursday
11030;Oberkampf - République;15;13;2;9;2025-06-05 01:00:25;2025-06-05;1;Thursday
17013;Legendre - Dulong;7;1;6;16;2025-06-05 01:00:15;2025-06-05;1;Thursday
19024;Botzaris - Parc des Buttes Chaumont;3;1;2;17;2025-06-05 00:58:37;2025-06-05;0;Thursday
23006;Jules Guesde - Alsace;13;7;6;12;2025-06-05 01:02:37;2025-06-05;1;Thursday
15021;Joseph Liouville - Croix Nivert;62;61;1;3;2025-06-05 01:03:28;2025-06-05;1;Thursday
9010;Rochechouart lamartine;4;2;2;20;2025-06-05 00:55:46;2025-06-05;0;Thursday
11105;Parmentier - République;9;8;1;13;2025-06-05 01:03:31;2025-06-05;1;Thursday
16108;Sablons - Georges Mandel;0;0;0;38;2025-06-05 01:00:07;2025-06-05;1;Thursday
19032;Villette - Belleville;25;9;16;17;2025-06-05 01:00:55;2025-06-05;1;Thursday
21701;Larmeroux - Baudelaire;24;15;9;5;2025-06-05 01:01:45;2025-06-05;1;Thursday
16008;Galilée - Kléber;2;1;1;28;2025-06-05 00:58:52;2025-06-05;0;Thursday
19022;Marché Secrétan;17;6;11;9;2025-06-05 01:02:13;2025-06-05;1;Thursday
13050;Quai Panhard et Levassor;1;1;0;55;2025-06-05 00:54:32;2025-06-05;0;Thursday
21008;Victor Hugo - Galliéni;13;12;1;19;2025-06-05 01:02:51;2025-06-05;1;Thursday
20134;Lieutenant Chauré - Etienne Marey;9;0;9;11;2025-06-05 01:01:33;2025-06-05;1;Thursday
24001;Arche - Léonard de Vinci;3;1;2;22;2025-06-05 01:01:17;2025-06-05;1;Thursday
32302;Chemin Vert - Fraternité;8;0;8;12;2025-06-05 00:55:18;2025-06-05;0;Thursday
10014;Marseille - Beaurepaire;14;11;3;38;2025-06-05 01:02:36;2025-06-05;1;Thursday
11035;Parmentier - Abel Rabaud;18;16;2;29;2025-06-05 01:01:09;2025-06-05;1;Thursday
42010;Mairie d'Ivry-sur-Seine;50;44;6;2;2025-06-05 01:02:51;2025-06-05;1;Thursday
46001;Place Paul Eluard;13;8;5;5;2025-06-05 01:03:33;2025-06-05;1;Thursday
21301;Saint-Vincent - Verdun;31;26;5;0;2025-06-05 01:03:33;2025-06-05;1;Thursday
9032;Mathurins - Auber;1;0;1;32;2025-06-05 00:59:30;2025-06-05;0;Thursday
19016;Hautpoul - Jean Jaurès;28;12;16;2;2025-06-05 01:01:55;2025-06-05;1;Thursday
32003;Wilson - Métallurgie;19;9;10;8;2025-06-05 01:03:03;2025-06-05;1;Thursday
21104;Madame de Sanzillon - Mozart;21;5;16;1;2025-06-05 01:03:25;2025-06-05;1;Thursday
11042;Grand Prieuré - Crussol;34;34;0;13;2025-06-05 01:02:00;2025-06-05;1;Thursday
32026;Leroy des Barres - Médiathèque;18;7;11;7;2025-06-05 01:03:01;2025-06-05;1;Thursday
1013;Place du Palais Royal;0;0;0;67;2025-06-05 00:59:27;2025-06-05;0;Thursday
8025;Miromesnil - La Boétie;2;0;2;32;2025-06-05 00:58:56;2025-06-05;0;Thursday
13002;Arago - Glacière;16;14;2;11;2025-06-05 00:58:39;2025-06-05;0;Thursday
19013;Laumière - Petit;29;19;10;4;2025-06-05 01:03:06;2025-06-05;1;Thursday
42504;Gare RER de Gentilly;10;2;8;20;2025-06-05 01:02:59;2025-06-05;1;Thursday
20111;Villiers de l'Isle Adam - Pyrénées;9;1;8;11;2025-06-05 00:59:11;2025-06-05;0;Thursday
20043;Charonne - Avron;9;4;5;17;2025-06-05 01:02:49;2025-06-05;1;Thursday
42015;Place Jean Ferrat;13;6;7;12;2025-06-05 01:02:33;2025-06-05;1;Thursday
32016;Place de la Porte de Paris;16;8;8;18;2025-06-05 01:02:59;2025-06-05;1;Thursday
31010;Stalingrad - Désiré Chevalier;6;2;4;36;2025-06-05 01:01:00;2025-06-05;1;Thursday
92008;Hôtel de Ville de Nanterre;7;4;3;29;2025-06-05 00:56:22;2025-06-05;0;Thursday
41402;Victor Hugo - Ecoles;23;13;10;1;2025-06-05 01:03:11;2025-06-05;1;Thursday
18012;Stephenson - Doudeauville;23;8;15;13;2025-06-05 01:00:43;2025-06-05;1;Thursday
19125;Place de l'Édit de Nantes;16;9;7;10;2025-06-05 01:03:08;2025-06-05;1;Thursday
19205;Simon Bolivar - Henri Turot;12;6;6;11;2025-06-05 01:01:01;2025-06-05;1;Thursday
11036;Jules Ferry - Faubourg du Temple Paris;50;48;2;7;2025-06-05 01:02:32;2025-06-05;1;Thursday
9021;Saint Georges - d'Aumale;1;0;1;22;2025-06-05 01:00:10;2025-06-05;1;Thursday
23009;Anatole France - Louise Michel;9;5;4;40;2025-06-05 01:01:58;2025-06-05;1;Thursday
12027;Montgallet - Charenton;15;15;0;1;2025-06-05 00:56:50;2025-06-05;0;Thursday
42029;Stalingrad - Germaine Tailleferre;24;17;7;1;2025-06-05 01:00:21;2025-06-05;1;Thursday
8035;Bienfaisance - Place de Narvik;5;3;2;31;2025-06-05 00:59:31;2025-06-05;0;Thursday
17102;Alfred Roll - Berthier;9;7;2;19;2025-06-05 00:59:58;2025-06-05;0;Thursday
16111;Faustin Hélie - Desbordes-Valmore;2;0;2;31;2025-06-05 01:02:52;2025-06-05;1;Thursday
11007;Jean Macé - Faidherbe;60;51;9;1;2025-06-05 01:02:56;2025-06-05;1;Thursday
15025;Dupleix - du Guesclin;44;39;5;1;2025-06-05 01:03:13;2025-06-05;1;Thursday
35018;Ancien Canal - Hélène Brion;21;14;7;1;2025-06-05 01:03:29;2025-06-05;1;Thursday
18110;Departement - Pajol;19;7;12;0;2025-06-05 01:00:30;2025-06-05;1;Thursday
10113;Parmentier - Hôpital Saint-Louis;15;12;3;27;2025-06-05 00:59:18;2025-06-05;0;Thursday
17045;Place des Ternes.;3;2;1;42;2025-06-05 00:58:13;2025-06-05;0;Thursday
43402;Place de Verdun;39;38;1;1;2025-06-05 01:01:34;2025-06-05;1;Thursday
33018;Edouard Poisson - Victor Hugo;28;21;7;1;2025-06-05 01:00:01;2025-06-05;1;Thursday
12013;Montgallet - Reuilly;15;10;5;0;2025-06-05 01:03:20;2025-06-05;1;Thursday
11115;Montreuil - Gonnet;23;22;1;1;2025-06-05 01:02:23;2025-06-05;1;Thursday
12115;Porte de Vincennes;7;5;2;26;2025-06-05 01:03:17;2025-06-05;1;Thursday
32303;Gaston Roussel - Commune de Paris;0;0;0;0;2018-08-13 06:11:15;2018-08-13;6;Monday
8033;Commandant Rivière;1;1;0;41;2025-06-05 00:56:37;2025-06-05;0;Thursday
15010;Square Cambronne;29;24;5;1;2025-06-05 01:02:54;2025-06-05;1;Thursday
41102;Gare de Laplace;6;0;6;36;2025-06-05 00:57:47;2025-06-05;0;Thursday
17037;Bayen - Pereire;11;8;3;10;2025-06-05 01:01:53;2025-06-05;1;Thursday
16124;Route de Sèvres - Porte de Bagatelle;28;25;3;32;2025-06-05 01:02:02;2025-06-05;1;Thursday
22505;Mairie de La Garenne Colombes;18;16;2;2;2025-06-05 00:56:58;2025-06-05;0;Thursday
16018;Flandrin - Henri Martin;4;2;2;13;2025-06-05 00:57:51;2025-06-05;0;Thursday
12034;Pirogues de Bercy - Libourne;3;3;0;45;2025-06-05 00:53:59;2025-06-05;0;Thursday
15033;Place Violet;28;27;1;2;2025-06-05 01:03:19;2025-06-05;1;Thursday
24002;Gare de Courbevoie;10;1;9;24;2025-06-05 01:03:07;2025-06-05;1;Thursday
33001;Victor Hugo - Magasins Généraux;2;0;2;31;2025-06-05 01:02:02;2025-06-05;1;Thursday
16034;Porte d'Auteuil;1;0;1;32;2025-06-05 01:00:41;2025-06-05;1;Thursday
41404;Carnot - Pâquerettes;25;21;4;0;2025-06-05 01:02:46;2025-06-05;1;Thursday
7009;Assemblée Nationale;0;0;0;75;2025-06-05 00:59:03;2025-06-05;0;Thursday
92003;Chanzy - Sud-Est;22;20;2;2;2025-06-05 01:03:30;2025-06-05;1;Thursday
35009;Jean Lolive - Parc Stalingrad;5;0;5;13;2025-06-05 01:00:22;2025-06-05;1;Thursday
8055;Courcelles - Place des Ternes;2;1;1;28;2025-06-04 15:13:27;2025-06-04;15;Wednesday
23701;Parvis Robert Schuman - Roger Salengro;17;6;11;5;2025-06-05 01:03:30;2025-06-05;1;Thursday
17007;Navier - Epinettes;18;5;13;35;2025-06-05 01:03:21;2025-06-05;1;Thursday
31012;Place Carnot;12;7;5;10;2025-06-05 01:02:05;2025-06-05;1;Thursday
12024;Gare de Bercy;9;3;6;26;2025-06-05 00:59:51;2025-06-05;0;Thursday
16129;Ceinture du Lac Inferieure - Saint-Cloud;3;2;1;38;2025-06-05 00:58:37;2025-06-05;0;Thursday
31705;Champeaux - Gallieni;9;2;7;41;2025-06-05 01:00:13;2025-06-05;1;Thursday
6030;Assas - Vaugirard;0;0;0;34;2025-06-05 00:53:52;2025-06-05;0;Thursday
23802;Raymond Poincaré - Allée de la Marche;5;1;4;18;2025-06-05 01:01:57;2025-06-05;1;Thursday
12126;Gravelle - Route du Bac;33;12;21;18;2025-06-05 01:02:57;2025-06-05;1;Thursday
15029;Emeriau - Place de Brazzaville;47;43;4;2;2025-06-05 01:02:18;2025-06-05;1;Thursday
17018;Parc Monceau;4;4;0;13;2025-06-05 00:54:47;2025-06-05;0;Thursday
10005;Petites Ecuries - Faubourg Poissonnière;6;3;3;11;2025-06-05 00:56:43;2025-06-05;0;Thursday
92004;Nanterre - Université;5;1;4;15;2025-06-05 01:02:49;2025-06-05;1;Thursday
18020;Francoeur - Marcadet;9;4;5;10;2025-06-05 01:00:09;2025-06-05;1;Thursday
43006;Vignerons - Minimes;19;11;8;10;2025-06-05 00:59:48;2025-06-05;0;Thursday
5002;Sommerard - Saint-Jacques;0;0;0;34;2025-06-05 00:54:56;2025-06-05;0;Thursday
15028;Grenelle - Dr Finlay;37;37;0;32;2025-06-05 01:02:26;2025-06-05;1;Thursday
14018;Porte d'Orléans;16;9;7;32;2025-06-05 00:58:33;2025-06-05;0;Thursday
21013;Pierre Grenier - Pont de Billancourt;21;18;3;0;2025-06-05 01:01:00;2025-06-05;1;Thursday
42503;Vladimir Ilitch Lénine - Andrée Chedid;15;2;13;16;2025-06-05 00:58:29;2025-06-05;0;Thursday
7006;Quai Voltaire;3;0;3;28;2025-06-05 00:54:04;2025-06-05;0;Thursday
7014;Saint-François-Xavier;5;3;2;35;2025-06-05 00:59:54;2025-06-05;0;Thursday
8012;Batignolles - Place de Clichy;3;1;2;41;2025-06-05 01:03:29;2025-06-05;1;Thursday
13026;Place Jean Delay;23;10;13;10;2025-06-05 01:02:18;2025-06-05;1;Thursday
23002;Pont de Levallois-bécon;7;4;3;42;2025-06-05 01:00:44;2025-06-05;1;Thursday
13102;Pitié-Salpêtrière;1;0;1;49;2025-06-05 00:55:30;2025-06-05;0;Thursday
10015;Lucien Sampaix - Récollets;14;14;0;32;2025-06-05 01:02:23;2025-06-05;1;Thursday
12011;Charenton - Place du Col Bourgoin;24;21;3;10;2025-06-05 01:03:33;2025-06-05;1;Thursday
21308;Bara - Henri Farman;4;2;2;53;2025-06-05 00:59:21;2025-06-05;0;Thursday
12032;Porte Dorée;23;16;7;13;2025-06-05 01:01:06;2025-06-05;1;Thursday
6103;Mézières - Rennes;1;0;1;51;2025-06-05 01:03:21;2025-06-05;1;Thursday
15038;Place Adolphe Cherioux - Vaugirard;57;46;11;2;2025-06-05 01:02:39;2025-06-05;1;Thursday
21032;Sèvres-Gallieni;13;12;1;13;2025-06-05 01:01:17;2025-06-05;1;Thursday
7005;Raspail - Bac;4;4;0;47;2025-06-05 00:56:39;2025-06-05;0;Thursday
6018;Michelet - Assas;4;3;1;14;2025-06-05 01:03:33;2025-06-05;1;Thursday
21019;Edouard Vaillant - Paul-Adolphe Souriau;16;13;3;11;2025-06-05 01:03:26;2025-06-05;1;Thursday
31019;Vincennes - Douy-Delcupe;3;2;1;35;2025-06-05 00:56:06;2025-06-05;0;Thursday
32014;Place du Cornillon - Stade de France;11;3;8;23;2025-06-05 00:59:29;2025-06-05;0;Thursday
17124;Porte de Saint-Ouen - Henri Huchard;2;0;2;23;2025-06-05 01:00:54;2025-06-05;1;Thursday
17027;Place du Maréchal Juin - Péreire;6;5;1;39;2025-06-05 01:01:35;2025-06-05;1;Thursday
31016;Lucie Aubrac - Franklin;8;4;4;28;2025-06-05 01:00:32;2025-06-05;1;Thursday
51003;Hôtel de Ville d'Argenteuil;27;8;19;1;2025-06-05 01:03:01;2025-06-05;1;Thursday
22101;Gare Routière de Saint Cloud;18;16;2;11;2025-06-05 01:02:43;2025-06-05;1;Thursday
2009;Filles Saint-Thomas - Place de la Bourse;1;0;1;56;2025-06-05 00:56:19;2025-06-05;0;Thursday
44102;Verdun - Adrien Damalix;20;8;12;3;2025-06-05 00:58:43;2025-06-05;0;Thursday
19039;Edouard Pailleron - Simon Bolivar;7;3;4;17;2025-06-05 01:01:16;2025-06-05;1;Thursday
16032;Eglise d'Auteuil;6;3;3;15;2025-06-05 01:03:07;2025-06-05;1;Thursday
18025;Mairie du 18ème;9;4;5;31;2025-06-05 01:01:30;2025-06-05;1;Thursday
20027;Porte de Ménilmontant;5;0;5;10;2025-06-05 00:57:47;2025-06-05;0;Thursday
9023;Laffitte - Italiens;0;0;0;33;2025-06-05 00:57:56;2025-06-05;0;Thursday
17047;Courcelles - Pierre Demours;7;4;3;19;2025-06-05 01:00:56;2025-06-05;1;Thursday
6016;Danton - Serpente;0;0;0;21;2025-06-05 00:53:54;2025-06-05;0;Thursday
17121;Square des Epinettes;10;5;5;10;2025-06-05 00:56:32;2025-06-05;0;Thursday
18109;Pajol - Riquet;21;9;12;24;2025-06-05 01:02:54;2025-06-05;1;Thursday
19038;Lassus - Delouvain;5;0;5;15;2025-06-05 00:59:04;2025-06-05;0;Thursday
18029;Emile Blemont - Poteau;8;4;4;29;2025-06-05 01:02:45;2025-06-05;1;Thursday
35017;Toffier Decaux - Cartier Bresson;3;0;3;12;2025-06-05 00:57:02;2025-06-05;0;Thursday
20118;Orteaux - Mouraud;11;4;7;13;2025-06-05 00:59:29;2025-06-05;0;Thursday
9031;Provence - Chaussée d'Antin;2;0;2;23;2025-06-05 00:55:37;2025-06-05;0;Thursday
20023;Pelleport - Belgrand;7;0;7;7;2025-06-05 01:03:22;2025-06-05;1;Thursday
18049;Porte d'Aubervilliers;5;3;2;49;2025-06-05 01:00:11;2025-06-05;1;Thursday
18113;Lepic - Armée d'Orient;2;1;1;22;2025-06-05 00:53:51;2025-06-05;0;Thursday
34010;Hôtel de Ville de Saint-Ouen;24;15;9;23;2025-06-05 01:03:09;2025-06-05;1;Thursday
31703;Sadi Carnot - François Mitterrand;14;2;12;12;2025-06-05 01:02:30;2025-06-05;1;Thursday
35003;Gabrielle Josserand - Edouard Vaillant;17;12;5;7;2025-06-05 01:03:26;2025-06-05;1;Thursday
21014;Hameau Fleuri - Marché;12;9;3;9;2025-06-05 00:55:55;2025-06-05;0;Thursday
5121;Square René Viviani - Montebello;2;1;1;30;2025-06-05 01:00:00;2025-06-05;1;Thursday
19127;Aubervilliers - Curial;9;3;6;14;2025-06-05 01:03:00;2025-06-05;1;Thursday
16015;Bassano -  Iéna;1;1;0;14;2025-06-05 00:58:28;2025-06-05;0;Thursday
1120;Lavandieres Sainte Opportune - Rivoli;0;0;0;27;2025-06-05 01:01:41;2025-06-05;1;Thursday
47004;Stade Auguste Delaune;21;19;2;0;2025-06-05 01:00:44;2025-06-05;1;Thursday
9026;Jean-Baptiste Pigalle - La Bruyere;1;0;1;15;2025-06-05 00:59:40;2025-06-05;0;Thursday
21001;Transvaal - Charles de Gaulle;2;2;0;25;2025-06-05 01:01:57;2025-06-05;1;Thursday
18033;Belliard - Damrémont;20;10;10;12;2025-06-05 01:02:52;2025-06-05;1;Thursday
16122;Route de la Muette - Porte de Neuilly;4;1;3;43;2025-06-05 01:01:58;2025-06-05;1;Thursday
15002;Maine - Antoine Bourdelle;2;1;1;15;2025-06-05 01:01:24;2025-06-05;1;Thursday
21310;Kléber - Gouverneur Général Eboué;22;21;1;1;2025-06-05 00:57:29;2025-06-05;0;Thursday
20116;Haies - Réunion;18;7;11;4;2025-06-05 01:02:02;2025-06-05;1;Thursday
16029;Maison de Radio - France;23;20;3;23;2025-06-05 01:02:07;2025-06-05;1;Thursday
8019;Naples - Rome;1;1;0;25;2025-06-05 01:01:35;2025-06-05;1;Thursday
18008;Square Léon;14;4;10;18;2025-06-05 01:03:19;2025-06-05;1;Thursday
16112;Chernoviz - Raynouard;3;1;2;34;2025-06-05 01:02:03;2025-06-05;1;Thursday
42703;Fontainebleau - Edmond Michelet;12;7;5;33;2025-06-05 00:58:00;2025-06-05;0;Thursday
14030;Pernety - Raymond Losserand;12;7;5;20;2025-06-05 00:58:10;2025-06-05;0;Thursday
20201;Eugène Reisz - Davout;9;4;5;11;2025-06-05 01:00:20;2025-06-05;1;Thursday
15003;Gare Montparnasse - Vaugirard;6;4;2;59;2025-06-05 00:58:13;2025-06-05;0;Thursday
4110;Neuve Saint-Pierre - Beautreillis;7;5;2;13;2025-06-05 00:59:37;2025-06-05;0;Thursday
6032;Sabot - Rennes;0;0;0;26;2025-06-05 00:57:24;2025-06-05;0;Thursday
17022;Pereire - Place de Wagram;8;4;4;37;2025-06-05 01:01:28;2025-06-05;1;Thursday
7020;Champ de Mars - Cler;18;16;2;22;2025-06-05 00:59:20;2025-06-05;0;Thursday
23304;Mairie de Sceaux;12;7;5;20;2025-06-05 01:01:06;2025-06-05;1;Thursday
12161;Diderot - Reuilly;23;13;10;21;2025-06-05 01:02:34;2025-06-05;1;Thursday
15107;Palais des Sports;21;20;1;1;2025-06-05 01:03:09;2025-06-05;1;Thursday
19041;Belleville - Pyrénées;9;0;9;31;2025-06-05 00:59:12;2025-06-05;0;Thursday
13103;Hôpital Pitié Salpêtrière;4;3;1;42;2025-06-05 00:59:38;2025-06-05;0;Thursday
23903;Stade Gaston Bouillant;25;19;6;4;2025-06-05 01:03:18;2025-06-05;1;Thursday
45001;Hôtel de Ville de Champigny sur Marne;20;13;7;1;2025-06-05 00:58:41;2025-06-05;0;Thursday
31023;Place François Mitterand;11;1;10;23;2025-06-05 00:56:45;2025-06-05;0;Thursday
9118;Faubourg Poissonniere - Delta;5;2;3;31;2025-06-05 00:59:50;2025-06-05;0;Thursday
2001;Greneta - Sebastopol;4;3;1;24;2025-06-05 01:02:54;2025-06-05;1;Thursday
20019;Place du Maquis du Vercors;16;14;2;14;2025-06-05 01:00:31;2025-06-05;1;Thursday
18137;Poissonniers - Nord;7;3;4;19;2025-06-05 00:58:36;2025-06-05;0;Thursday
15059;Parc André Citroën;0;0;0;65;2025-06-05 01:02:34;2025-06-05;1;Thursday
17116;Reims - Porte d'Asnières;4;4;0;20;2025-06-05 00:59:29;2025-06-05;0;Thursday
7016;Surcouf - Université;3;1;2;54;2025-06-05 01:00:07;2025-06-05;1;Thursday
12108;Bercy.;6;5;1;60;2025-06-05 01:02:23;2025-06-05;1;Thursday
7013;Duroc - Place de Breteuil;4;3;1;37;2025-06-05 00:59:14;2025-06-05;0;Thursday
8056;Beaujon - Wagram;2;0;2;27;2025-06-05 00:57:55;2025-06-05;0;Thursday
17016;Brochant - Square des Batignolles;16;10;6;11;2025-06-05 01:03:23;2025-06-05;1;Thursday
18019;Square Raymond Souplex;11;2;9;41;2025-06-05 00:54:26;2025-06-05;0;Thursday
9012;Rougemont - Poissonnière;0;0;0;42;2025-06-05 01:02:00;2025-06-05;1;Thursday
15020;Mairie du 15ème;31;29;2;0;2025-06-05 01:02:30;2025-06-05;1;Thursday
41206;Place des Larris;6;3;3;28;2025-06-05 01:00:30;2025-06-05;1;Thursday
13113;Vistule - Choisy;12;7;5;21;2025-06-05 01:02:27;2025-06-05;1;Thursday
19031;Manin - Crimée;22;4;18;1;2025-06-05 00:59:05;2025-06-05;0;Thursday
13114;Nationale - Marcel Duchamp;17;7;10;6;2025-06-05 01:03:07;2025-06-05;1;Thursday
20017;Saint-Blaise - Mouraud;13;8;5;11;2025-06-05 01:01:57;2025-06-05;1;Thursday
23008;Hôtel de Ville de Levallois Perret;25;15;10;0;2025-06-05 01:02:19;2025-06-05;1;Thursday
21108;Mairie de Clichy;40;18;22;6;2025-06-05 01:01:30;2025-06-05;1;Thursday
14116;Romain Rolland;6;2;4;19;2025-06-05 01:02:59;2025-06-05;1;Thursday
31018;Gambetta - Michelet;29;6;23;3;2025-06-05 00:58:16;2025-06-05;0;Thursday
47002;Les Juilliottes;19;13;6;1;2025-06-05 01:03:33;2025-06-05;1;Thursday
1016;Thérèse - Opéra;0;0;0;24;2025-06-05 01:00:31;2025-06-05;1;Thursday
14007;Ferrus - Saint-Jacques;12;7;5;22;2025-06-05 00:59:00;2025-06-05;0;Thursday
11107;Faidherbe - Dahomey;42;37;5;0;2025-06-05 01:01:43;2025-06-05;1;Thursday
9113;Bleue - Trévise;11;11;0;17;2025-06-05 00:57:27;2025-06-05;0;Thursday
2014;Daunou - Louis le Grand;2;0;2;29;2025-06-05 00:55:28;2025-06-05;0;Thursday
8049;Georges V - François 1er;0;0;0;22;2025-06-05 00:58:16;2025-06-05;0;Thursday
11048;Place Mireille Havet;41;39;2;1;2025-06-05 01:02:08;2025-06-05;1;Thursday
2101;Bachaumont - Montmartre;1;1;0;32;2025-06-05 01:02:26;2025-06-05;1;Thursday
19030;Melun - Jean Jaurès;13;11;2;15;2025-06-05 01:00:27;2025-06-05;1;Thursday
22002;Argenson - Château;2;1;1;23;2025-06-05 00:56:48;2025-06-05;0;Thursday
13019;Fernand Braudel - Vincent Auriol;1;0;1;34;2025-06-05 01:00:35;2025-06-05;1;Thursday
5030;Sorbonne - Ecoles;1;1;0;49;2025-06-05 00:55:34;2025-06-05;0;Thursday
16041;Versailles - Claude Terrasse;16;15;1;28;2025-06-05 01:00:42;2025-06-05;1;Thursday
17033;Carnot - Général Lanrezac;0;0;0;30;2025-06-05 01:01:55;2025-06-05;1;Thursday
12153;Terroirs de France - Lheureux;8;4;4;47;2025-06-05 01:02:36;2025-06-05;1;Thursday
17005;Brochant - Clichy;24;19;5;29;2025-06-05 01:01:20;2025-06-05;1;Thursday
14016;René Coty - Parc Montsouris;6;3;3;49;2025-06-05 00:57:54;2025-06-05;0;Thursday
12033;François Truffaut - Saint Emilion;11;10;1;51;2025-06-05 00:57:42;2025-06-05;0;Thursday
22012;Madeleine Michelis - Roule;11;5;6;14;2025-06-05 00:59:30;2025-06-05;0;Thursday
18035;René Binet - Porte de Montmartre;19;11;8;18;2025-06-05 01:02:10;2025-06-05;1;Thursday
14125;Dareau - Broussais;20;15;5;3;2025-06-05 01:03:08;2025-06-05;1;Thursday
31017;Jean Moulin - Paul Doumer;8;0;8;12;2025-06-05 01:02:45;2025-06-05;1;Thursday
44103;Pont De Charenton;15;11;4;2;2025-06-05 01:02:57;2025-06-05;1;Thursday
4107;Beaumarchais - Pas de la Mule;4;1;3;14;2025-06-05 00:54:22;2025-06-05;0;Thursday
42011;Quai Marcel Boyer - Victor Hugo;24;20;4;2;2025-06-05 01:02:12;2025-06-05;1;Thursday
21951;Place Centrale;2;0;2;18;2025-06-05 01:01:45;2025-06-05;1;Thursday
92005;Gare de Nanterre Ville;31;31;0;11;2025-06-05 01:02:11;2025-06-05;1;Thursday
22103;Senard - Charles Blum;2;1;1;19;2025-06-05 00:58:47;2025-06-05;0;Thursday
10039;Sambre et Meuse - Villette;5;3;2;17;2025-06-05 01:02:41;2025-06-05;1;Thursday
31101;Jules Guesde - Laennec;8;0;8;11;2025-06-05 00:55:55;2025-06-05;0;Thursday
35004;Place du Président Salvador Allende;8;2;6;49;2025-06-05 01:00:52;2025-06-05;1;Thursday
31707;Edouard Vaillant - Galliéni;11;4;7;38;2025-06-05 01:01:04;2025-06-05;1;Thursday
8011;Clapeyron - Moscou;3;0;3;12;2025-06-05 00:58:02;2025-06-05;0;Thursday
14113;Santé - Arago;14;9;5;23;2025-06-05 01:03:06;2025-06-05;1;Thursday
35015;Averroès - Aimé Césaire;16;10;6;2;2025-06-05 01:02:41;2025-06-05;1;Thursday
32021;Place du Front Populaire - George Sand;7;1;6;56;2025-06-05 00:58:22;2025-06-05;0;Thursday
20203;Evariste Galois;9;0;9;7;2025-06-05 00:58:57;2025-06-05;0;Thursday
7024;Rapp - Place du Général Gouraud;7;6;1;21;2025-06-05 00:59:14;2025-06-05;0;Thursday
20004;Commandant l'Herminier - Gallieni;10;7;3;7;2025-06-05 01:03:17;2025-06-05;1;Thursday
11031;Jacquard - Ternaux;34;33;1;4;2025-06-05 01:02:43;2025-06-05;1;Thursday
12125;Pyramide - Parc Floral;7;5;2;42;2025-06-05 01:00:38;2025-06-05;1;Thursday
13515;Auguste Blanqui - Glacière;6;2;4;51;2025-06-05 00:58:02;2025-06-05;0;Thursday
9016;Choron - Martyrs;1;0;1;16;2025-06-05 00:59:57;2025-06-05;0;Thursday
10152;Gare du Nord - Place de Valenciennes;2;1;1;22;2025-06-05 01:03:30;2025-06-05;1;Thursday
15125;Parc Suzanne Lenglen;3;1;2;45;2025-06-05 00:59:27;2025-06-05;0;Thursday
10004;Metz - Faubourg Saint-Denis;1;1;0;45;2025-06-05 01:02:35;2025-06-05;1;Thursday
21118;Neuilly - Petit;5;2;3;10;2025-06-05 01:00:45;2025-06-05;1;Thursday
20039;Belleville - Couronnes;19;12;7;29;2025-06-05 00:55:46;2025-06-05;0;Thursday
16003;André Maurois - Joseph et Marie Hackin;3;3;0;25;2025-06-05 01:00:43;2025-06-05;1;Thursday
12006;Gare de Lyon - Van Gogh;1;1;0;40;2025-06-05 00:55:05;2025-06-05;0;Thursday
16014;Eylau - Trocadéro;3;0;3;20;2025-06-05 00:58:20;2025-06-05;0;Thursday
22013;Mairie de Neuilly sur Seine;5;3;2;24;2025-06-05 01:02:43;2025-06-05;1;Thursday
10110;Louis Blanc - Jemmapes;11;7;4;18;2025-06-05 01:01:06;2025-06-05;1;Thursday
21708;Marcel Yol - Jullien;8;6;2;22;2025-06-05 00:59:46;2025-06-05;0;Thursday
21307;Victor Cresson - Telles de la Poterie;29;27;2;0;2025-06-05 01:01:25;2025-06-05;1;Thursday
41210;Hôtel de ville de Fontenay-sous-Bois;12;2;10;7;2025-06-05 01:02:48;2025-06-05;1;Thursday
21702;Gare SNCF Vanves-Malakoff;18;5;13;31;2025-06-05 01:02:52;2025-06-05;1;Thursday
42304;Marc Sangnier - Division Leclerc;23;17;6;1;2025-06-05 01:01:32;2025-06-05;1;Thursday
44002;Paul Vaillant-Couturier - Gare RER;10;8;2;16;2025-06-05 01:00:26;2025-06-05;1;Thursday
16115;Raffet - Montmorency;4;2;2;36;2025-06-05 01:02:41;2025-06-05;1;Thursday
15123;Commerce - Letellier;39;33;6;4;2025-06-05 01:03:31;2025-06-05;1;Thursday
21030;Fessart - Château;9;7;2;10;2025-06-05 00:59:30;2025-06-05;0;Thursday
21031;Cimetière de Boulogne-Billancourt;36;36;0;2;2025-06-05 01:03:23;2025-06-05;1;Thursday
16024;Ranelagh - Maison de la Radio;9;9;0;13;2025-06-05 01:02:20;2025-06-05;1;Thursday
15043;Brancion - Lefebvre;10;4;6;1;2025-06-05 01:01:15;2025-06-05;1;Thursday
20009;Docteurs Déjérine - Pte de Montreuil;6;4;2;13;2025-06-05 00:58:43;2025-06-05;0;Thursday
42305;Vanne - Saussaies;19;8;11;0;2025-06-05 01:02:10;2025-06-05;1;Thursday
11032;Jean-Pierre Timbaud - Vaucouleurs;42;36;6;5;2025-06-05 01:01:46;2025-06-05;1;Thursday
21955;Vaugirard - Verrerie;18;13;5;3;2025-06-05 01:03:23;2025-06-05;1;Thursday
16101;Malakoff - Place de la Porte Maillot;2;0;2;25;2025-06-05 01:02:15;2025-06-05;1;Thursday
10012;Vinaigriers - Magenta;3;1;2;22;2025-06-05 01:03:11;2025-06-05;1;Thursday
13048;Wurtz - Tolbiac;26;21;5;0;2025-06-05 01:01:45;2025-06-05;1;Thursday
21028;Pierre Lefaucheux - Traversière;28;27;1;6;2025-06-05 00:57:33;2025-06-05;0;Thursday
21219;Amaury Duval - Gabriel Péri;8;3;5;27;2025-06-05 00:55:50;2025-06-05;0;Thursday
5014;Jean Calvin - Tournefort;1;0;1;27;2025-06-05 01:03:19;2025-06-05;1;Thursday
20007;Buzenval - Avron;15;9;6;35;2025-06-05 01:01:38;2025-06-05;1;Thursday
15023;La Motte-Picquet - Grenelle;10;7;3;23;2025-06-05 01:03:27;2025-06-05;1;Thursday
42003;Place de l'Insurrection d'Août 1944;29;27;2;0;2025-06-05 01:03:23;2025-06-05;1;Thursday
12043;Daumesnil - Hébrard;33;28;5;7;2025-06-05 01:02:48;2025-06-05;1;Thursday
4002;Marché aux fleurs;1;0;1;22;2025-06-05 01:02:17;2025-06-05;1;Thursday
10105;Mazagran - Bonne Nouvelle;0;0;0;24;2025-06-05 01:03:23;2025-06-05;1;Thursday
17003;Jacques Kellner - Saint-Ouen;36;16;20;9;2025-06-05 00:55:05;2025-06-05;0;Thursday
42501;Raspail - Albert Schweitzer;25;19;6;2;2025-06-05 00:58:11;2025-06-05;0;Thursday
13109;Brillat-Savarin - Küss;16;12;4;3;2025-06-05 01:02:34;2025-06-05;1;Thursday
21204;Estienne d'Orves - Henri Ginoux;14;6;8;17;2025-06-05 01:00:38;2025-06-05;1;Thursday
21217;Louis Rolland - République;2;1;1;23;2025-06-05 01:00:51;2025-06-05;1;Thursday
9114;Faubourg Poissonnière - Dunkerque;1;0;1;27;2025-06-05 00:58:57;2025-06-05;0;Thursday
47001;Place de la Gare;40;38;2;4;2025-06-05 01:03:15;2025-06-05;1;Thursday
15064;Javel - André Citroën;40;37;3;4;2025-06-05 01:02:21;2025-06-05;1;Thursday
14010;Jean Moulin - Place Victor et Hélène Basch;10;7;3;30;2025-06-05 00:58:53;2025-06-05;0;Thursday
43001;Paris - Laitières;0;0;0;0;2025-06-05 00:58:20;2025-06-05;0;Thursday
22303;Lucien Lanternier - Le Luth;27;21;6;0;2025-06-05 01:02:40;2025-06-05;1;Thursday
16002;Pergolèse - Malakoff;3;1;2;35;2025-06-05 01:02:58;2025-06-05;1;Thursday
15004;Vaugirard - Pasteur;1;0;1;20;2025-06-05 01:01:53;2025-06-05;1;Thursday
18007;Goutte d'or - Barbès;14;8;6;4;2025-06-05 01:02:42;2025-06-05;1;Thursday
19128;Quai de l'Oise - Aisne;21;15;6;8;2025-06-05 01:01:37;2025-06-05;1;Thursday
15005;Place Jacques et Thérèse Tréfouël;3;2;1;37;2025-06-05 01:02:19;2025-06-05;1;Thursday
13044;Place Jeanne d'Arc;7;3;4;28;2025-06-05 00:55:32;2025-06-05;0;Thursday
9027;Douai - Pierre Fontaine;2;1;1;23;2025-06-05 01:03:34;2025-06-05;1;Thursday
4020;Place Edmond Michelet;1;0;1;21;2025-06-05 01:02:27;2025-06-05;1;Thursday
15022;Emile Zola - Fondary;40;35;5;2;2025-06-05 01:02:16;2025-06-05;1;Thursday
23004;Paul Vaillant-Couturier - Victor Hugo;17;6;11;17;2025-06-05 00:57:31;2025-06-05;0;Thursday
11017;Charonne - Bureau;20;12;8;25;2025-06-05 00:59:56;2025-06-05;0;Thursday
21306;Place Lafayette;3;1;2;57;2025-06-05 00:59:01;2025-06-05;0;Thursday
1021;Halles - Bourdonnais;1;0;1;19;2025-06-05 01:01:45;2025-06-05;1;Thursday
33015;Charles Tillon - Cimetière Communal;26;17;9;3;2025-06-05 01:01:02;2025-06-05;1;Thursday
7017;La Motte-Picquet - La Tour Maubourg;10;9;1;26;2025-06-05 01:01:00;2025-06-05;1;Thursday
41205;Maréchal Joffre - Verdun;8;0;8;12;2025-06-05 01:03:24;2025-06-05;1;Thursday
22015;Île de la Jatte;8;4;4;15;2025-06-05 01:02:59;2025-06-05;1;Thursday
44016;Balzac - Olympes de Gouges;25;14;11;3;2025-06-05 00:57:10;2025-06-05;0;Thursday
17119;Toqueville - Cardinet;13;6;7;20;2025-06-05 00:58:03;2025-06-05;0;Thursday
15011;Cambronne - Villa Croix Nivert;60;54;6;1;2025-06-05 01:02:46;2025-06-05;1;Thursday
9004;Gérando - Rochechouart;0;0;0;20;2025-06-05 00:59:52;2025-06-05;0;Thursday
51002;Placette Grégoire Collas;23;19;4;0;2025-06-05 00:59:36;2025-06-05;0;Thursday
33016;Fort d'Aubervilliers;18;8;10;3;2025-06-05 01:01:20;2025-06-05;1;Thursday
10162;Alexandre Parodi - Quai de Valmy;1;0;1;23;2025-06-05 00:57:14;2025-06-05;0;Thursday
6012;Saint-Germain - Ciseaux;1;0;1;16;2025-06-05 01:02:17;2025-06-05;1;Thursday
8201;Arsène Houssaye - Friedland;0;0;0;29;2025-06-05 00:55:36;2025-06-05;0;Thursday
17111;Lemercier - Cardinet;11;9;2;10;2025-06-05 01:00:09;2025-06-05;1;Thursday
21319;Esplanade du Foncet - Camille Desmoulins;21;18;3;7;2025-06-05 01:00:51;2025-06-05;1;Thursday
9102;Londres - Place d'Estienne d'Orves;1;1;0;23;2025-06-05 00:53:49;2025-06-05;0;Thursday
18030;Joseph Dijon - Ornano;20;12;8;17;2025-06-05 01:02:17;2025-06-05;1;Thursday
31005;Square Denise Buisson;8;1;7;35;2025-06-05 00:56:20;2025-06-05;0;Thursday
21314;Chemin de Bretagne;27;21;6;1;2025-06-05 01:03:29;2025-06-05;1;Thursday
12005;Crozatier - Faubourg Saint-Antoine;39;37;2;1;2025-06-05 01:02:22;2025-06-05;1;Thursday
13516;Glacière - Soeur Catherine Marie;20;18;2;19;2025-06-05 00:59:20;2025-06-05;0;Thursday
9011;Geoffroy - Marie;2;1;1;18;2025-06-05 00:57:55;2025-06-05;0;Thursday
41211;Louis Xavier de Ricard - Ancienne Mairie;6;3;3;27;2025-06-05 01:02:47;2025-06-05;1;Thursday
2108;Vivienne - Montmartre;0;0;0;36;2025-06-05 01:03:08;2025-06-05;1;Thursday
12101;Charenton - Prague;19;12;7;4;2025-06-05 01:03:31;2025-06-05;1;Thursday
21707;Square Etienne Jarousse;10;3;7;12;2025-06-05 01:02:32;2025-06-05;1;Thursday
5001;Harpe - Saint-Germain;1;1;0;42;2025-06-05 01:01:32;2025-06-05;1;Thursday
15129;Hôpital Necker;4;2;2;31;2025-06-05 00:59:31;2025-06-05;0;Thursday
51001;Gare d'Argenteuil;7;2;5;33;2025-06-05 01:02:13;2025-06-05;1;Thursday
8027;Mairie du 8ème;1;0;1;13;2025-06-05 00:53:44;2025-06-05;0;Thursday
23102;Hôtel de Ville de Sèvres;27;23;4;3;2025-06-05 01:03:14;2025-06-05;1;Thursday
15006;Cherche-Midi - Hôpital Necker;3;3;0;35;2025-06-05 00:55:40;2025-06-05;0;Thursday
15036;Croix Nivert - Square Saint-Lambert;1;0;1;46;2025-03-03 09:03:43;2025-03-03;9;Monday
41403;Gare RER - Malleret-Joinville;19;10;9;0;2025-06-05 00:58:34;2025-06-05;0;Thursday
33014;Parc Eli Lotar;15;2;13;5;2025-06-05 01:01:05;2025-06-05;1;Thursday
9007;Condorcet - Turgot;0;0;0;19;2025-06-05 00:53:47;2025-06-05;0;Thursday
13052;Leredde - Tolbiac;33;29;4;11;2025-06-05 01:02:22;2025-06-05;1;Thursday
15127;Place Charles Michels;31;29;2;6;2025-06-05 01:01:13;2025-06-05;1;Thursday
20105;Benoît Frachon - République;1;1;0;29;2025-06-05 01:00:34;2025-06-05;1;Thursday
33103;Jean Jaurès - Jules Jacquemin;16;1;15;7;2025-06-05 01:01:47;2025-06-05;1;Thursday
14032;Mairie du 14ème;6;5;1;26;2025-06-05 01:00:35;2025-06-05;1;Thursday
14011;Place des Droits de l'Enfant;29;20;9;9;2025-06-05 01:02:40;2025-06-05;1;Thursday
41401;Marne - Charles de Gaulle;27;15;12;0;2025-06-05 01:02:13;2025-06-05;1;Thursday
6002;Saint-Benoît - Jacob;2;1;1;21;2025-06-05 01:03:33;2025-06-05;1;Thursday
14031;Didot - Place de Moro-Giafferi;8;2;6;14;2025-06-05 01:02:47;2025-06-05;1;Thursday
20044;Davout - Volga;19;4;15;6;2025-06-05 01:02:17;2025-06-05;1;Thursday
15070;Balard - Montagne de la Fage;0;0;0;36;2025-06-05 00:53:46;2025-06-05;0;Thursday
10019;Paradis - Hauteville;17;17;0;14;2025-06-05 01:03:07;2025-06-05;1;Thursday
11033;Bréguet - Sabin;26;23;3;7;2025-06-05 01:02:25;2025-06-05;1;Thursday
10033;Gare du Nord - Saint-Vincent de Paul;6;2;4;18;2025-06-05 01:01:46;2025-06-05;1;Thursday
40006;Université Paris Est Créteil;2;1;1;41;2025-06-05 01:03:09;2025-06-05;1;Thursday
20022;Porte de Bagnolet;3;0;3;29;2025-06-05 00:57:01;2025-06-05;0;Thursday
12036;Reuilly - Place Felix Eboue;28;17;11;14;2025-06-05 01:01:23;2025-06-05;1;Thursday
10008;Cité Riverin - Château d'Eau;10;8;2;7;2025-06-05 01:02:58;2025-06-05;1;Thursday
16036;Porte Molitor;2;0;2;57;2025-06-05 00:54:13;2025-06-05;0;Thursday
8117;Place de la Madeleine - Royale;0;0;0;42;2025-06-05 01:02:03;2025-06-05;1;Thursday
10032;Claude Vellefaux - Hôpital Saint-Louis;21;13;8;7;2025-06-05 01:02:10;2025-06-05;1;Thursday
12015;Place de la Nation - Picpus;18;8;10;18;2025-06-05 01:02:15;2025-06-05;1;Thursday
48004;Maxime Gorki - Louis Aragon;6;3;3;11;2025-06-05 01:03:06;2025-06-05;1;Thursday
14001;Edgar Quinet - Gaité;1;1;0;25;2025-06-05 00:57:06;2025-06-05;0;Thursday
26004;Gare RER les Grésillons;19;14;5;1;2025-06-05 01:02:19;2025-06-05;1;Thursday
18139;Poissonniers - Championnet;10;8;2;15;2025-06-05 01:03:00;2025-06-05;1;Thursday
16042;Murat - Porte de Saint-Cloud;4;1;3;32;2025-06-05 01:01:48;2025-06-05;1;Thursday
1006;Grande Truanderie - Saint-Denis;1;0;1;31;2025-06-05 00:57:45;2025-06-05;0;Thursday
15001;Gare Montparnasse - Arrivée;1;0;1;41;2025-06-05 01:00:54;2025-06-05;1;Thursday
22201;Henri Ravera - Gabriel Péri;14;3;11;12;2025-06-05 01:02:53;2025-06-05;1;Thursday
11112;Jules Vallès - Charonne;23;21;2;0;2025-06-05 01:01:11;2025-06-05;1;Thursday
5007;Ecoles - Carmes;1;1;0;34;2025-06-05 00:58:17;2025-06-05;0;Thursday
4006;Bourdon - Pont Morland;10;7;3;41;2025-06-05 01:03:34;2025-06-05;1;Thursday
18202;Diane Arbus;7;4;3;31;2025-06-05 01:01:35;2025-06-05;1;Thursday
5015;Epée de Bois - Mouffetard;4;3;1;55;2025-06-05 01:00:07;2025-06-05;1;Thursday
15128;Cadix - Hameau;34;28;6;2;2025-06-05 01:01:21;2025-06-05;1;Thursday
44014;Camille Risch - Paul Armangot;10;2;8;15;2025-06-05 01:03:15;2025-06-05;1;Thursday
12037;Reuilly - Daumesnil;15;4;11;21;2025-06-05 01:03:28;2025-06-05;1;Thursday
1007;Turbigo - Française;1;0;1;14;2025-06-05 01:01:17;2025-06-05;1;Thursday
47003;Charentonneau - Maisons Alfort;18;15;3;2;2025-06-05 01:01:26;2025-06-05;1;Thursday
16013;Mairie du 16ème;6;2;4;29;2025-06-05 00:58:42;2025-06-05;0;Thursday
7012;Cité Vaneau;5;3;2;21;2025-06-05 01:02:41;2025-06-05;1;Thursday
20008;Pyrénées - Avron;6;1;5;22;2025-06-05 00:55:46;2025-06-05;0;Thursday
12019;Gare de Reuilly - Picpus;15;10;5;12;2025-06-05 01:03:33;2025-06-05;1;Thursday
20104;Louis Lumière.;15;4;11;7;2025-06-05 01:00:31;2025-06-05;1;Thursday
14135;Jourdan - Cité Universitaire;16;9;7;21;2025-06-05 00:57:29;2025-06-05;0;Thursday
8110;Gare Saint-Lazare - Stockholm;2;2;0;29;2025-06-05 00:59:02;2025-06-05;0;Thursday
12156;Niger - Soult;14;13;1;9;2025-06-05 01:00:16;2025-06-05;1;Thursday
18140;Porte de Clignancourt - Ney;10;4;6;29;2025-06-05 00:57:18;2025-06-05;0;Thursday
19002;Centquatre;31;15;16;9;2025-06-05 01:01:47;2025-06-05;1;Thursday
9009;Square Montholon;2;1;1;17;2025-06-05 01:02:02;2025-06-05;1;Thursday
6104;Herschel - Observatoire;1;0;1;36;2025-06-05 01:02:01;2025-06-05;1;Thursday
20034;Sorbier - Ménilmontant;2;0;2;20;2025-06-05 01:01:54;2025-06-05;1;Thursday
20001;Place de la Nation - Charonne;13;8;5;22;2025-06-05 01:02:55;2025-06-05;1;Thursday
16037;Molitor - Michel-Ange;0;0;0;0;2018-03-20 09:09:28;2018-03-20;9;Tuesday
19201;Petit - Georges Thill;11;4;7;12;2025-06-05 00:56:28;2025-06-05;0;Thursday
19010;Emile Reynaud - Porte de la Villette;20;10;10;0;2025-06-05 01:00:45;2025-06-05;1;Thursday
15132;Bargue -  Dutot;12;7;5;9;2025-06-05 01:03:32;2025-06-05;1;Thursday
41405;Place de l'Europe - Alfortville;21;14;7;1;2025-06-05 01:03:04;2025-06-05;1;Thursday
20006;Pyrénées - Plaine;6;4;2;4;2025-06-05 00:58:45;2025-06-05;0;Thursday
8028;Arsène Houssaye - Champs-Elysées;3;0;3;26;2025-06-05 00:57:34;2025-06-05;0;Thursday
10011;Bourse du Travail;8;2;6;6;2025-06-05 01:02:38;2025-06-05;1;Thursday
14137;Maurice d'Ocagne - General Maudhuy;0;0;0;29;2025-06-05 01:02:46;2025-06-05;1;Thursday
14019;Sarrette - Général Leclerc;7;2;5;15;2025-06-05 01:00:20;2025-06-05;1;Thursday
31709;Place de la Fraternité;20;7;13;1;2025-06-05 01:03:11;2025-06-05;1;Thursday
10027;Dunkerque - Alsace;5;2;3;15;2025-06-05 01:01:51;2025-06-05;1;Thursday
22401;Charles de Gaulle - Plateau de Vanves;2;2;0;30;2025-06-05 01:02:43;2025-06-05;1;Thursday
12002;Lacuée - Lyon;2;1;1;13;2025-06-05 01:02:29;2025-06-05;1;Thursday
4103;Archives - Rivoli;2;1;1;21;2025-06-05 01:02:46;2025-06-05;1;Thursday
14103;Maine - Liancourt;1;0;1;26;2025-06-05 01:01:25;2025-06-05;1;Thursday
3001;Beaumarchais - Saint-Gilles;22;21;1;29;2025-06-05 01:01:12;2025-06-05;1;Thursday
9037;Parme - Clichy;0;0;0;24;2025-06-05 01:01:52;2025-06-05;1;Thursday
7021;Bosquet - Saint-Dominique;7;4;3;18;2025-06-05 01:01:31;2025-06-05;1;Thursday
21026;Sèvres - Général Leclerc;0;0;0;26;2025-06-05 01:01:58;2025-06-05;1;Thursday
22503;Joffre - Aigle;5;2;3;15;2025-06-05 01:02:19;2025-06-05;1;Thursday
1102;Française - Etienne Marcel;0;0;0;37;2025-06-05 01:03:08;2025-06-05;1;Thursday
12020;Cours de Vincennes - Soult;17;5;12;28;2025-06-05 01:03:21;2025-06-05;1;Thursday
2021;Cléry - Montmartre;0;0;0;56;2025-06-05 00:59:54;2025-06-05;0;Thursday
3009;Temple - Haudriettes;2;0;2;16;2025-06-05 00:57:52;2025-06-05;0;Thursday
3005;Sainte-Elisabeth - Turbigo;0;0;0;33;2024-06-02 06:46:29;2024-06-02;6;Sunday
2005;Montmartre - Etienne Marcel;2;0;2;13;2025-06-05 01:02:37;2025-06-05;1;Thursday
23702;Hôtel de Ville de Chaville;12;6;6;8;2025-06-05 01:03:06;2025-06-05;1;Thursday
19012;Lally-Tollendal - Armand Carrel;8;3;5;19;2025-06-05 01:01:02;2025-06-05;1;Thursday
22306;Place du 17 Octobre;20;15;5;0;2025-06-05 01:01:31;2025-06-05;1;Thursday
14023;Adolphe Pinard - Victor Hugo;7;3;4;45;2025-06-05 00:54:32;2025-06-05;0;Thursday
3006;Mairie du 3ème;7;2;5;24;2025-06-05 01:00:45;2025-06-05;1;Thursday
4015;Mairie du 4ème;3;2;1;40;2025-06-05 00:59:52;2025-06-05;0;Thursday
3003;Fille du Calvaire - Turenne;14;8;6;14;2025-06-05 01:02:28;2025-06-05;1;Thursday
19111;Cesaria Evora - Rosa Parks;22;14;8;16;2025-06-05 01:02:17;2025-06-05;1;Thursday
13125;Gare d'Austerlitz - Pont Charles de Gaulle;2;1;1;53;2025-06-05 01:01:20;2025-06-05;1;Thursday
48005;Eugène Varlin - Place de la Paix;9;1;8;13;2025-06-05 01:02:10;2025-06-05;1;Thursday
14133;Froidevaux - Boulard;6;1;5;27;2025-06-05 01:03:31;2025-06-05;1;Thursday
21215;Verdier - Jean Jaurès;14;3;11;18;2025-06-05 01:01:23;2025-06-05;1;Thursday
4017;Place de l'Hôtel de Ville;1;0;1;13;2025-06-05 00:56:32;2025-06-05;0;Thursday
26006;Bas - Gabriel Péri;26;16;10;1;2025-06-05 01:02:42;2025-06-05;1;Thursday
12163;Hippodrome Paris-Vincennes;4;2;2;38;2025-06-05 01:02:26;2025-06-05;1;Thursday
21509;Gardenat Lapostol - Franklin Roosevelt;4;1;3;20;2025-06-05 00:59:44;2025-06-05;0;Thursday
13054;Pau Casals - Neuve Tolbiac;2;2;0;49;2025-06-05 01:02:17;2025-06-05;1;Thursday
35012;Candale - Mehul;14;6;8;11;2025-06-05 00:58:02;2025-06-05;0;Thursday
21505;Édouard Vaillant - Place Jean Jaurès;9;3;6;15;2025-06-05 01:03:06;2025-06-05;1;Thursday
2016;Aboukir - Alexandrie;2;2;0;18;2025-06-05 01:00:02;2025-06-05;1;Thursday
4018;Saint-Bon - Rivoli;1;0;1;30;2025-06-05 01:01:02;2025-06-05;1;Thursday
44001;Quai Jules Guesde - Saint-Simon;28;21;7;1;2025-06-05 01:02:54;2025-06-05;1;Thursday
4007;Place de la Bastille - Bourdon;2;1;1;33;2025-06-05 01:01:58;2025-06-05;1;Thursday
10041;Gare du Nord - La Chapelle;7;3;4;8;2025-06-05 00:58:54;2025-06-05;0;Thursday
2012;Choiseul - Quatre Septembre;2;1;1;9;2025-06-05 00:55:03;2025-06-05;0;Thursday
4101;Bastille - Beaumarchais;5;4;1;18;2025-06-05 01:01:00;2025-06-05;1;Thursday
33020;Waldeck Rochet - Germaine Tillon;20;8;12;9;2025-06-05 01:00:32;2025-06-05;1;Thursday
1018;Alger - Rivoli;2;0;2;19;2025-06-05 00:56:30;2025-06-05;0;Thursday
2008;Mairie du 2ème;1;1;0;27;2025-06-05 00:58:59;2025-06-05;0;Thursday
1026;Place du Lieutenant Henri Karcher;1;0;1;28;2025-06-05 01:01:50;2025-06-05;1;Thursday
23101;Grande Rue - Europe;18;12;6;6;2025-06-05 01:03:13;2025-06-05;1;Thursday
17106;Berthier - Porte de Clichy;4;0;4;19;2025-06-05 01:03:00;2025-06-05;1;Thursday
6026;Saint-Placide - Cherche Midi;2;2;0;62;2025-06-05 00:56:45;2025-06-05;0;Thursday
22601;Marx Dormoy - Château Sainte-Barbe;11;4;7;11;2025-06-05 01:00:42;2025-06-05;1;Thursday
1023;Saint-Honoré - Musée du Louvre;1;1;0;29;2025-06-05 00:58:53;2025-06-05;0;Thursday
48008;Guy Môquet - Parvis Georges Marchais;4;2;2;26;2025-06-05 00:59:09;2025-06-05;0;Thursday
19202;Marseillaise - Grenade;21;7;14;22;2025-06-05 01:02:39;2025-06-05;1;Thursday
5003;Le Goff - Gay-Lussac;2;0;2;33;2025-06-05 01:01:37;2025-06-05;1;Thursday
27001;Square Victor Basch;12;8;4;8;2025-06-05 01:02:53;2025-06-05;1;Thursday
43403;Gare RER - Canadiens;27;17;10;11;2025-06-05 01:02:14;2025-06-05;1;Thursday
12164;Stade Pershing;0;0;0;25;2025-06-05 01:03:26;2025-06-05;1;Thursday
31020;Résistance - Parmentier;4;1;3;31;2025-06-05 01:00:16;2025-06-05;1;Thursday
28005;Jean Jaurès - Paul Lafargue;15;4;11;12;2025-06-05 00:56:55;2025-06-05;0;Thursday
35005;Quai de l'Aisne - Général Leclerc;19;8;11;6;2025-06-05 01:01:13;2025-06-05;1;Thursday
18112;Arthur Ranc - Hôpital Bichat;13;4;9;11;2025-06-05 01:03:13;2025-06-05;1;Thursday
12166;Parc Floral du Bel Air;8;4;4;16;2025-06-05 00:57:05;2025-06-05;0;Thursday
32022;Henri Barbusse - Marcel Cachin;0;0;0;0;2025-02-24 10:20:03;2025-02-24;10;Monday
27006;Victor Hugo - Gare;22;15;7;1;2025-06-05 00:58:17;2025-06-05;0;Thursday
9019;Victor Massé - Jean-Baptiste Pigalle;2;0;2;16;2025-06-05 01:01:35;2025-06-05;1;Thursday
2102;Saint-Marc - Feydeau;0;0;0;35;2025-06-05 01:00:56;2025-06-05;1;Thursday
2020;Danielle Casanova - Opéra;0;0;0;20;2025-06-05 00:59:58;2025-06-05;0;Thursday
10201;Magenta - Chabrol;4;0;4;18;2025-06-05 01:00:34;2025-06-05;1;Thursday
12016;Saint-Mande - Picpus;13;8;5;22;2025-06-05 01:01:00;2025-06-05;1;Thursday
23301;Les Blagis;27;23;4;0;2025-06-05 01:02:52;2025-06-05;1;Thursday
42210;Victor Hugo - Paul Eluard;19;12;7;12;2025-06-05 01:03:18;2025-06-05;1;Thursday
44008;Youri Gagarine - Commune de Paris;30;13;17;3;2025-06-05 01:03:34;2025-06-05;1;Thursday
21011;Silly - Louis Blériot;16;16;0;4;2025-06-05 00:55:21;2025-06-05;0;Thursday
20140;Paganini - Davout;4;2;2;17;2025-06-05 01:02:45;2025-06-05;1;Thursday
23303;Gare de Robinson;10;7;3;20;2025-06-05 01:00:12;2025-06-05;1;Thursday
26012;Jardin Modèle - Pierre Boudou;18;13;5;0;2025-06-05 01:03:10;2025-06-05;1;Thursday
20048;Bagnolet - Place Saint-Blaise;8;4;4;20;2025-06-05 01:03:10;2025-06-05;1;Thursday
45004;République - Louis Loucheur;33;17;16;3;2025-06-05 01:01:56;2025-06-05;1;Thursday
23202;Henri Barbusse - Gabriel Péri;7;1;6;9;2025-06-05 00:57:59;2025-06-05;0;Thursday
6015;André Mazet - Saint-André des Arts;1;0;1;54;2025-06-05 00:53:53;2025-06-05;0;Thursday
8202;Londres - Europe;0;0;0;26;2025-06-05 01:00:40;2025-06-05;1;Thursday
32011;Stade de France - Francis de Pressensé;5;1;4;37;2025-06-05 01:01:38;2025-06-05;1;Thursday
8040;Pierre Charron - Champs-Elysées;1;0;1;29;2025-06-05 00:57:54;2025-06-05;0;Thursday
10202;Bichat - Grange aux Belles;8;4;4;20;2025-06-05 01:03:29;2025-06-05;1;Thursday
24004;Paix - Verdun;0;0;0;0;2025-05-15 10:55:31;2025-05-15;10;Thursday
18010;Riquet - Marx Dormoy;31;17;14;4;2025-06-05 01:02:33;2025-06-05;1;Thursday
48001;Chastenet de Géry - Marcel Paul;11;1;10;14;2025-06-05 00:58:04;2025-06-05;0;Thursday
24101;Place Charles de Gaulle;9;0;9;14;2025-06-05 01:03:28;2025-06-05;1;Thursday
21329;Gare - Aristide Briand;29;26;3;0;2025-06-05 01:02:47;2025-06-05;1;Thursday
19121;Belleville -  Pré Saint-Gervais;6;0;6;15;2025-06-05 01:02:06;2025-06-05;1;Thursday
13015;Chevaleret - Louise Weiss;6;4;2;28;2025-06-05 01:02:31;2025-06-05;1;Thursday
19114;Manin - Secrétan;4;3;1;16;2025-06-05 01:00:03;2025-06-05;1;Thursday
13024;Bobillot - Tolbiac;33;26;7;0;2025-06-05 01:02:39;2025-06-05;1;Thursday
19006;Mathis - Flandre;0;0;0;0;2024-09-05 10:54:01;2024-09-05;10;Thursday
23041;Général Leclerc - Bièvre;16;10;6;9;2025-06-05 00:57:53;2025-06-05;0;Thursday
31104;Mairie de Rosny-sous-Bois;21;7;14;8;2025-06-05 01:02:38;2025-06-05;1;Thursday
5027;Gobelins - Port-Royal;33;27;6;2;2025-06-05 00:58:34;2025-06-05;0;Thursday
13116;Place du Docteur Yersin;9;5;4;40;2025-06-05 01:02:23;2025-06-05;1;Thursday
11111;Léon Frot - Charonne;17;15;2;1;2025-06-05 01:01:15;2025-06-05;1;Thursday
48006;Maxime Gorki - Paul Vaillant-Couturier;7;0;7;13;2025-06-05 01:00:43;2025-06-05;1;Thursday
15012;Cambronne - Mademoiselle;61;50;11;1;2025-06-05 01:02:47;2025-06-05;1;Thursday
18016;Francoeur - Caulaincourt;9;2;7;24;2025-06-05 01:01:25;2025-06-05;1;Thursday
19117;Euryale Dehaynin - Loire;6;3;3;20;2025-06-05 01:00:31;2025-06-05;1;Thursday
21022;Dôme - République;24;20;4;1;2025-06-05 01:00:22;2025-06-05;1;Thursday
15041;Franquet - Labrouste;29;18;11;8;2025-06-05 00:59:43;2025-06-05;0;Thursday
10003;Hauteville - Bonne Nouvelle;6;4;2;10;2025-06-04 22:43:07;2025-06-04;22;Wednesday
41103;Place de la vache noire;9;2;7;16;2025-06-05 01:02:24;2025-06-05;1;Thursday
13028;Gouthière - Poterne des Peupliers;32;27;5;0;2025-06-05 01:00:41;2025-06-05;1;Thursday
20012;Buzenval - Vignoles;6;5;1;10;2025-06-05 01:01:46;2025-06-05;1;Thursday
14004;Port Royal - Hôpital Cochin;4;2;2;19;2025-06-05 00:58:12;2025-06-05;0;Thursday
42303;Place Eustache Deschamps;18;13;5;1;2025-06-05 01:00:29;2025-06-05;1;Thursday
48002;LCL Campus - Place Oscar Niemeyer;8;0;8;27;2025-06-05 01:00:45;2025-06-05;1;Thursday
30003;Moscou - Edouard Vaillant;19;13;6;10;2025-06-05 01:03:20;2025-06-05;1;Thursday
35013;Guillaume Tell - Parc Henri Barbusse;17;4;13;2;2025-06-05 00:58:55;2025-06-05;0;Thursday
20020;Pyrénées - Charles Renouvier;7;2;5;22;2025-06-05 00:57:51;2025-06-05;0;Thursday
12008;Hector Malot - Daumesnil;28;24;4;23;2025-06-05 01:01:28;2025-06-05;1;Thursday
12102;Bercy - Traversiére;4;2;2;23;2025-06-05 00:56:07;2025-06-05;0;Thursday
13120;Pierre Joseph Desault;18;18;0;0;2025-06-05 01:02:03;2025-06-05;1;Thursday
12119;Dom-Pérignon - Gravelle;33;28;5;14;2025-06-05 01:02:07;2025-06-05;1;Thursday
13006;Duméril - Jeanne d'Arc;24;20;4;15;2025-06-05 00:59:33;2025-06-05;0;Thursday
43007;Hôtel de Ville de Vincennes;11;8;3;16;2025-06-05 01:00:34;2025-06-05;1;Thursday
15050;Dominique Pado - Croix Nivert;18;16;2;3;2025-06-05 00:58:44;2025-06-05;0;Thursday
13036;Olympiades;5;4;1;30;2025-06-05 01:01:48;2025-06-05;1;Thursday
43004;Montreuil - République;22;10;12;2;2025-06-05 01:00:21;2025-06-05;1;Thursday
17117;Pereire - Saussure;10;9;1;21;2025-06-05 01:01:41;2025-06-05;1;Thursday
16017;Siam - La Pompe;3;1;2;13;2025-06-05 00:58:22;2025-06-05;0;Thursday
5033;Saint-Séverin - Saint-Michel;1;1;0;27;2025-06-05 01:01:45;2025-06-05;1;Thursday
15045;Porte de la Plaine;2;1;1;33;2025-06-05 01:01:34;2025-06-05;1;Thursday
12022;Sahel - Général Michel Bizot;15;8;7;30;2025-06-03 22:03:29;2025-06-03;22;Tuesday
21023;Ancienne Mairie - André Morizet;17;11;6;6;2025-06-05 01:03:24;2025-06-05;1;Thursday
42205;Place Aristide Briand;31;24;7;0;2025-06-05 01:01:23;2025-06-05;1;Thursday
22701;Général Leclerc - République;29;24;5;1;2025-06-05 01:03:14;2025-06-05;1;Thursday
31701;Mairie de Bagnolet;27;5;22;0;2025-06-05 01:00:13;2025-06-05;1;Thursday
22404;Pierre Brossolette - 12 Février 1934;18;3;15;6;2025-06-05 01:02:25;2025-06-05;1;Thursday
20014;Charonne - Alexandre Dumas;10;3;7;25;2025-06-05 01:03:28;2025-06-05;1;Thursday
14035;Maine - Jean Zay;5;2;3;44;2025-06-05 00:59:46;2025-06-05;0;Thursday
8046;Marceau - Président Wilson;3;1;2;28;2025-06-05 01:03:26;2025-06-05;1;Thursday
20110;Gambetta - Tourelles;1;0;1;19;2025-06-05 01:03:13;2025-06-05;1;Thursday
14005;René Coty - Place Denfert-Rochereau;5;0;5;31;2025-06-05 01:03:34;2025-06-05;1;Thursday
8007;Rome - Provence;2;0;2;28;2025-06-05 00:59:00;2025-06-05;0;Thursday
17006;Guy Môquet - Compoint;24;21;3;12;2025-06-05 01:03:33;2025-06-05;1;Thursday
21207;Verdier - République;9;6;3;20;2025-06-05 00:56:44;2025-06-05;0;Thursday
16023;Passy - Place du Costa Rica;6;2;4;26;2025-06-05 00:57:37;2025-06-05;0;Thursday
6004;Regard - Rennes;3;1;2;43;2025-06-05 01:03:20;2025-06-05;1;Thursday
11029;Ménilmontant - Oberkampf;10;2;8;29;2025-06-05 01:01:36;2025-06-05;1;Thursday
11028;Guillaume Bertrand - République;31;24;7;6;2025-06-05 00:59:26;2025-06-05;0;Thursday
22014;Victor Hugo - Bineau;10;4;6;15;2025-06-05 01:01:09;2025-06-05;1;Thursday
21027;Fief - République;20;19;1;5;2025-06-05 00:56:46;2025-06-05;0;Thursday
15113;Arsonval - Falguière;5;2;3;20;2025-06-05 01:01:12;2025-06-05;1;Thursday
16022;Jean Bologne - Passy;2;0;2;17;2025-06-05 00:56:54;2025-06-05;0;Thursday
20011;Pyrénées - Dagorno;12;7;5;6;2025-06-05 01:01:27;2025-06-05;1;Thursday
19001;Crimée - Ourcq;25;11;14;31;2025-06-05 01:01:14;2025-06-05;1;Thursday
13023;Bobillot - Moulin des Prés;10;1;9;18;2025-06-05 00:59:32;2025-06-05;0;Thursday
12040;Porte de Charenton;18;11;7;46;2025-06-05 01:03:18;2025-06-05;1;Thursday
20106;Mairie du 20ème;3;1;2;24;2025-06-05 00:56:11;2025-06-05;0;Thursday
6020;Place Saint-André des Arts;4;1;3;32;2025-06-05 01:02:47;2025-06-05;1;Thursday
21007;Rond-Point Rhin et Danube;48;48;0;1;2025-06-05 01:02:14;2025-06-05;1;Thursday
19007;Flandre - Ourcq;24;14;10;3;2025-06-05 01:01:05;2025-06-05;1;Thursday
21016;Point du Jour - Jean Jaurès;39;39;0;1;2025-06-05 01:03:18;2025-06-05;1;Thursday
11018;Saint-Maur - République;23;21;2;13;2025-06-05 01:01:58;2025-06-05;1;Thursday
19123;Metz - Marne;6;3;3;25;2025-06-05 01:01:05;2025-06-05;1;Thursday
21107;Bertrand Sincholle - Henri Barbusse;20;15;5;1;2025-06-05 00:59:53;2025-06-05;0;Thursday
22007;Commandant Charcot - Bretteville;17;11;6;19;2025-06-05 01:02:56;2025-06-05;1;Thursday
12039;Général Michel Bizot - Claude Decaen;35;27;8;1;2025-06-05 01:03:23;2025-06-05;1;Thursday
13037;Ivry - Baudricourt;12;6;6;7;2025-06-05 01:01:52;2025-06-05;1;Thursday
6009;Guynemer - Jardin du Luxembourg;2;2;0;34;2025-06-05 00:56:26;2025-06-05;0;Thursday
16104;Paul Valery - Victor Hugo;2;0;2;33;2025-06-05 01:01:01;2025-06-05;1;Thursday
20033;Etienne Dolet - Place Maurice Chevalier;10;8;2;36;2025-06-05 01:01:29;2025-06-05;1;Thursday
30005;Convention - Campus de Bobigny;23;15;8;8;2025-06-05 01:02:13;2025-06-05;1;Thursday
21510;Fontaine du Tertre - Calvaire;14;11;3;10;2025-06-05 00:54:10;2025-06-05;0;Thursday
51007;Résistance - Romain Rolland;4;2;2;24;2025-06-05 00:59:47;2025-06-05;0;Thursday
11040;Temple - Jean-Pierre Timbaud;13;10;3;23;2025-06-05 00:57:43;2025-06-05;0;Thursday
13008;Place d'Italie - Soeur Rosalie;5;0;5;46;2025-06-05 01:01:25;2025-06-05;1;Thursday
21511;Marcel Monge - Marcel Dassault;22;16;6;21;2025-06-05 01:00:13;2025-06-05;1;Thursday
21033;Sèvres - Maréchal Juin;16;16;0;1;2025-06-05 01:03:05;2025-06-05;1;Thursday
21112;Claude Debussy - Marc Bloch;33;22;11;21;2025-06-05 01:03:33;2025-06-05;1;Thursday
22703;Place Jean Mermoz;26;14;12;0;2025-06-05 01:02:05;2025-06-05;1;Thursday
24010;Charles de Gaulle - Rue de l'Alma;6;1;5;21;2025-06-05 00:58:13;2025-06-05;0;Thursday
25009;Place des Arts - Jean Mermoz;20;18;2;0;2025-06-05 01:03:24;2025-06-05;1;Thursday
20030;Ménilmontant - Père Lachaise;5;0;5;33;2025-06-05 01:02:28;2025-06-05;1;Thursday
20035;Pyrénées - Ménilmontant;6;0;6;19;2025-06-05 00:59:10;2025-06-05;0;Thursday
21508;Georges Pompidou - Verdun;21;21;0;4;2025-06-05 00:58:18;2025-06-05;0;Thursday
20037;Gambetta - Saint Fargeau;7;0;7;16;2025-06-05 00:59:31;2025-06-05;0;Thursday
19045;Macdonald - Césaria Evora;5;5;0;61;2025-06-05 01:01:27;2025-06-05;1;Thursday
22302;Gare RER - Général de Gaulle;17;5;12;23;2025-06-05 01:03:33;2025-06-05;1;Thursday
48011;Epi d'Or - Chevilly;15;6;9;4;2025-06-05 00:59:09;2025-06-05;0;Thursday
41212;Nungesser - Santé;20;4;16;1;2025-06-05 01:01:58;2025-06-05;1;Thursday
34009;Dora Maar - Nadia Guendouz;21;10;11;5;2025-06-05 01:03:34;2025-06-05;1;Thursday
10151;Gare du Nord - Faubourg Saint-Denis;8;2;6;20;2025-06-05 01:03:15;2025-06-05;1;Thursday
18018;Carpeaux - Place Jacques Froment;9;5;4;10;2025-06-05 01:00:43;2025-06-05;1;Thursday
10025;Jemmapes - Ecluses Saint-Martin;6;4;2;7;2025-06-05 00:57:33;2025-06-05;0;Thursday
21954;Val-Fleury;11;3;8;12;2025-06-05 01:02:34;2025-06-05;1;Thursday
11201;Faubourg St-Antoine - Place de la Nation;4;2;2;12;2025-06-05 01:01:37;2025-06-05;1;Thursday
22602;Place Henri Dunant - Gare RER;10;8;2;21;2025-06-05 00:55:31;2025-06-05;0;Thursday
12106;Gare de Lyon - Roland Barthes;5;2;3;63;2025-06-05 00:57:46;2025-06-05;0;Thursday
12001;Bastille - Biscornet;2;1;1;60;2025-06-05 00:53:54;2025-06-05;0;Thursday
22018;Charles de Gaulle - Les Sablons;4;0;4;31;2025-06-05 00:56:55;2025-06-05;0;Thursday
21320;Président Roosevelt - Rouget de Lisle;1;0;1;38;2025-06-05 01:03:33;2025-06-05;1;Thursday
23203;Division Leclerc - Kléber;7;2;5;18;2025-06-05 01:02:20;2025-06-05;1;Thursday
26009;Marceau Delorme - Pierre Brossolette;27;20;7;1;2025-06-05 01:02:35;2025-06-05;1;Thursday
34008;Garibaldi - Gabriel Péri;27;17;10;2;2025-06-05 01:01:23;2025-06-05;1;Thursday
34012;Bateliers - Quai de Seine;24;16;8;0;2025-06-05 00:59:31;2025-06-05;0;Thursday
23204;Roland Garros - Jean Bouin;14;8;6;14;2025-06-05 01:02:37;2025-06-05;1;Thursday
31301;Gare RER;22;9;13;6;2025-06-05 01:02:46;2025-06-05;1;Thursday
21514;Place de la Paix - Abbé Saint-Pierre;1;1;0;22;2025-06-05 01:02:49;2025-06-05;1;Thursday
31303;Simone Signoret - Paris;19;10;9;7;2025-06-05 01:02:39;2025-06-05;1;Thursday
5107;Pontoise - La Tournelle;0;0;0;21;2025-06-05 00:58:32;2025-06-05;0;Thursday
10026;Gare de l'Est - Chateau Landon;21;11;10;33;2025-06-05 01:03:25;2025-06-05;1;Thursday
17010;Jonquière - Docteur Paul Brousse;33;18;15;4;2025-06-05 01:01:36;2025-06-05;1;Thursday
18023;Ordener - Poissonniers;22;15;7;13;2025-06-05 01:01:24;2025-06-05;1;Thursday
18024;Clignancourt - Ordener;13;6;7;22;2025-06-05 01:03:17;2025-06-05;1;Thursday
16006;Lauriston - Copernic;0;0;0;19;2025-06-05 00:58:47;2025-06-05;0;Thursday
8008;Joseph Sansboeuf - Saint Lazare;1;0;1;28;2025-06-05 01:03:23;2025-06-05;1;Thursday
31202;Gabriel Péri - Jules Ferry;19;9;10;6;2025-06-05 01:01:11;2025-06-05;1;Thursday
31201;Suzanne Masson;28;8;20;8;2025-06-05 01:02:48;2025-06-05;1;Thursday
13035;Choisy - Tolbiac;4;2;2;15;2025-06-05 01:02:13;2025-06-05;1;Thursday
10114;Granges aux Belles - Hôpital Saint-Louis;21;17;4;39;2025-06-05 01:03:26;2025-06-05;1;Thursday
13203;Square de Choisy - Eastman;1;0;1;22;2025-06-05 01:03:10;2025-06-05;1;Thursday
13202;Place Farhat Hached;3;1;2;25;2025-06-05 00:54:19;2025-06-05;0;Thursday
18042;Place Pigalle;2;1;1;16;2025-06-05 01:03:19;2025-06-05;1;Thursday
11037;Faubourg Du Temple - Republique;1;1;0;33;2025-06-05 01:02:36;2025-06-05;1;Thursday
12157;Fabre d'Eglantine - Place de la Nation;25;5;20;43;2025-06-05 01:03:05;2025-06-05;1;Thursday
11102;Alexandre Dumas - Voltaire;57;44;13;1;2025-06-05 01:02:55;2025-06-05;1;Thursday
16103;Traktir - Foch;0;0;0;22;2025-06-05 00:59:41;2025-06-05;0;Thursday
11046;Place de la République - Voltaire;5;2;3;10;2025-06-05 01:03:17;2025-06-05;1;Thursday
11009;Boulets - Voltaire;23;14;9;1;2025-06-05 01:03:23;2025-06-05;1;Thursday
35001;Jean Jaurès - Ouvrières Pivéreuses;23;15;8;0;2025-06-05 01:00:09;2025-06-05;1;Thursday
15060;Place de la Montagne du Goulet;17;14;3;1;2025-06-05 01:02:18;2025-06-05;1;Thursday
11011;Richard Lenoir - Voltaire;20;19;1;2;2025-06-05 01:03:34;2025-06-05;1;Thursday
11012;Montreuil - Voltaire;22;17;5;12;2025-06-05 01:02:04;2025-06-05;1;Thursday
15105;Fédération - Suffren;9;5;4;16;2025-06-05 01:02:15;2025-06-05;1;Thursday
8039;Colisée - Champs-Elysées;0;0;0;17;2025-06-05 00:54:11;2025-06-05;0;Thursday
7023;Bourdonnais - Tour Eiffel;6;3;3;54;2025-06-05 01:03:01;2025-06-05;1;Thursday
7025;Octave Gréard - Tour Eiffel;4;2;2;28;2025-06-05 01:00:36;2025-06-05;1;Thursday
40007;Préfecture de Créteil;17;10;7;9;2025-06-05 01:02:29;2025-06-05;1;Thursday
40010;Haut du Mont-Mesly;16;3;13;5;2025-06-05 01:03:15;2025-06-05;1;Thursday
40012;Stade de la Habette;7;2;5;1;2025-06-05 01:03:13;2025-06-05;1;Thursday
40013;Hôtel de Ville de Créteil;11;6;5;27;2025-06-05 01:02:35;2025-06-05;1;Thursday
40014;Créteil Pointe du Lac;24;10;14;5;2025-06-05 01:03:09;2025-06-05;1;Thursday
23011;Bineau - Louise Michel;8;7;1;16;2025-06-05 00:58:19;2025-06-05;0;Thursday
23801;Place de la Gare;1;1;0;17;2025-06-05 00:54:55;2025-06-05;0;Thursday
22504;Château - République;0;0;0;0;2024-07-30 07:44:13;2024-07-30;7;Tuesday
23703;Gare de Chaville Rive Gauche;9;0;9;8;2025-06-05 01:01:59;2025-06-05;1;Thursday
13106;Bobillot - Paulin Mery;18;13;5;5;2025-06-05 01:02:59;2025-06-05;1;Thursday
51005;Yves Farges - Route d'Enghien;20;2;18;14;2025-06-05 01:03:08;2025-06-05;1;Thursday
10031;Louis Blanc - Aqueduc;18;11;7;18;2025-06-05 01:01:05;2025-06-05;1;Thursday
32004;Wilson - Landy;17;5;12;21;2025-06-05 01:02:48;2025-06-05;1;Thursday
10013;Alibert - Jemmapes;32;29;3;27;2025-06-05 01:01:55;2025-06-05;1;Thursday
19203;Pailleron - Bouret;3;0;3;22;2025-06-05 01:03:07;2025-06-05;1;Thursday
27004;Gare de la Garenne-Colombes;20;12;8;7;2025-06-05 00:59:57;2025-06-05;0;Thursday
19018;Cité de la Musique;12;5;7;47;2025-06-05 01:03:11;2025-06-05;1;Thursday
8052;Balzac - Champs Elysées;0;0;0;30;2025-06-05 01:01:41;2025-06-05;1;Thursday
13123;BNF - Bibliothèque Nationale de France;3;3;0;33;2025-06-05 01:00:23;2025-06-05;1;Thursday
18203;Lamarck - Saint-Ouen;0;0;0;40;2025-06-05 00:59:35;2025-06-05;0;Thursday
40002;Bleuets - Bordières;11;8;3;10;2025-06-05 00:58:51;2025-06-05;0;Thursday
15122;Place Charles Vallin;27;23;4;3;2025-06-05 01:00:04;2025-06-05;1;Thursday
12615;Welovegreen;0;0;0;599;2025-06-04 12:41:45;2025-06-04;12;Wednesday
18043;Clichy - Place Blanche;6;0;6;13;2025-06-05 01:01:45;2025-06-05;1;Thursday
9104;Caumartin - Provence;0;0;0;21;2025-06-05 00:58:46;2025-06-05;0;Thursday
5202;Arbalète - Claude Bernard;15;11;4;15;2025-06-05 01:03:00;2025-06-05;1;Thursday
8004;Malesherbes - Place de la Madeleine;1;0;1;66;2025-06-05 00:54:24;2025-06-05;0;Thursday
4005;Quai des Célestins - Henri IV;0;0;0;0;2018-10-16 04:53:12;2018-10-16;4;Tuesday
14111;Cassini - Denfert-Rochereau;3;2;1;22;2025-06-05 01:02:33;2025-06-05;1;Thursday
5110;Lacépède - Monge;13;5;8;10;2025-06-05 00:59:26;2025-06-05;0;Thursday
33006;André Karman - République;28;15;13;2;2025-06-05 01:02:01;2025-06-05;1;Thursday
21010;Silly - Galliéni;20;16;4;3;2025-06-05 01:02:28;2025-06-05;1;Thursday
30002;Jean Rostand - Paul Vaillant Couturier;8;1;7;27;2025-06-05 01:02:15;2025-06-05;1;Thursday
7003;Square Boucicaut;3;2;1;56;2025-06-05 01:03:13;2025-06-05;1;Thursday
17041;Guersant - Gouvion-Saint-Cyr;15;9;6;18;2025-06-05 01:02:41;2025-06-05;1;Thursday
5016;Thouin - Cardinal Lemoine;3;0;3;14;2025-06-05 00:59:40;2025-06-05;0;Thursday
15047;Morillons - Dantzig;29;13;16;23;2025-06-05 01:01:19;2025-06-05;1;Thursday
17026;Jouffroy d'Abbans - Wagram;15;5;10;25;2025-06-05 01:03:11;2025-06-05;1;Thursday
14108;Le Brix et Mesmin - Jourdan;6;5;1;15;2025-06-05 00:57:17;2025-06-05;0;Thursday
17044;Porte de Saint-Ouen - Bessières;4;0;4;36;2025-06-05 00:54:50;2025-06-05;0;Thursday
19033;Cambrai - Benjamin Constant;0;0;0;42;2025-06-05 01:01:58;2025-06-05;1;Thursday
43002;Lagny - Victor Basch;15;8;7;10;2025-06-05 01:00:59;2025-06-05;1;Thursday
16138;Saint-Cloud - Hippodrome;1;1;0;28;2025-06-05 00:58:47;2025-06-05;0;Thursday
15068;Général Martial Valin - Pont du Garigliano;3;1;2;12;2025-06-05 01:00:22;2025-06-05;1;Thursday
17048;De Toqueville - Terrasse;4;2;2;24;2025-06-05 01:02:55;2025-06-05;1;Thursday
2017;Caire - Dussoubs;2;1;1;37;2025-06-05 01:03:00;2025-06-05;1;Thursday
8103;Artois - Berri;0;0;0;23;2025-06-05 01:02:21;2025-06-05;1;Thursday
13118;Regnault - Patay;51;47;4;9;2025-06-05 01:03:26;2025-06-05;1;Thursday
9002;Abbeville - Faubourg Poissonnière;6;5;1;6;2025-06-05 01:02:23;2025-06-05;1;Thursday
48003;Youri Gagarine - Karl Marx;4;1;3;17;2025-06-05 01:01:20;2025-06-05;1;Thursday
16110;Octave Feuillet - Albéric Magnard;3;3;0;18;2025-06-05 00:54:41;2025-06-05;0;Thursday
9001;Bellefond - Poissonnière;5;4;1;11;2025-06-05 01:00:44;2025-06-05;1;Thursday
17032;Jean Oestreicher - Porte de Champerret;2;2;0;19;2025-06-05 00:59:46;2025-06-05;0;Thursday
8016;Square Louis XVI;1;0;1;26;2025-06-05 00:57:52;2025-06-05;0;Thursday
10029;Dunkerque - Rocroy;6;2;4;17;2025-06-05 00:58:25;2025-06-05;0;Thursday
17040;Pereire - Ternes;6;4;2;42;2025-06-05 01:02:32;2025-06-05;1;Thursday
9038;Douai - Bruxelles;3;2;1;24;2025-06-05 01:00:53;2025-06-05;1;Thursday
17008;Porte Pouchet-Bessières;8;7;1;14;2025-06-05 01:02:07;2025-06-05;1;Thursday
7018;Ségur - d'Estrées;2;2;0;16;2025-06-05 00:55:00;2025-06-05;0;Thursday
9014;Faubourg Montmartre - La Fayette;1;1;0;33;2025-06-05 00:58:48;2025-06-05;0;Thursday
9106;Boudreau - Auber;0;0;0;27;2025-06-05 01:01:37;2025-06-05;1;Thursday
19105;Ambroise Rendu - Porte Brunet;5;1;4;11;2025-06-05 00:57:10;2025-06-05;0;Thursday
19015;Thionville - Ourcq;14;11;3;9;2025-06-05 00:58:56;2025-06-05;0;Thursday
9022;Rossini - Laffitte;1;1;0;31;2025-06-05 00:55:02;2025-06-05;0;Thursday
26003;Argenteuil - Voltaire;14;10;4;1;2025-06-05 01:00:22;2025-06-05;1;Thursday
17004;Legendre - Clichy;18;14;4;21;2025-06-05 01:00:26;2025-06-05;1;Thursday
12151;Gare de Lyon - Place Louis Armand;2;1;1;58;2025-06-05 00:58:28;2025-06-05;0;Thursday
16026;Ranelagh - Mozart;3;0;3;5;2025-06-05 01:01:57;2025-06-05;1;Thursday
9028;Moncey - Blanche;2;1;1;15;2025-06-05 00:56:08;2025-06-05;0;Thursday
10107;Gare du Nord - Hôpital Lariboisière;6;1;5;42;2025-06-05 00:58:30;2025-06-05;0;Thursday
45003;11 Novembre 1918 - 8 Mai 1945;8;7;1;28;2025-06-05 00:57:53;2025-06-05;0;Thursday
11002;Roquette - Thiéré;17;13;4;5;2025-06-05 01:00:27;2025-06-05;1;Thursday
12111;Claude Decaen - Cannebière;23;14;9;21;2025-06-05 01:01:38;2025-06-05;1;Thursday
19043;Delphine Seyrig - Général Leclerc;10;4;6;41;2025-06-05 00:55:39;2025-06-05;0;Thursday
5032;Panthéon - Valette;1;0;1;36;2025-06-05 00:58:13;2025-06-05;0;Thursday
12128;Pyramide - Ecole du Breuil;8;8;0;26;2025-06-05 01:00:19;2025-06-05;1;Thursday
31022;Mairie de Montreuil;14;9;5;38;2025-06-05 01:03:10;2025-06-05;1;Thursday
10016;Récollets - Square Villemin;0;0;0;17;2025-06-05 01:02:38;2025-06-05;1;Thursday
31009;Place Du Général De Gaulle;13;0;13;13;2025-06-05 01:01:01;2025-06-05;1;Thursday
41302;Charles de Gaulle - Beauté;8;3;5;39;2025-06-05 01:00:36;2025-06-05;1;Thursday
14020;Cimetière de Montrouge;6;4;2;52;2025-06-05 00:56:04;2025-06-05;0;Thursday
33017;Anatole France - President Roosevelt;24;12;12;4;2025-06-05 01:03:18;2025-06-05;1;Thursday
15042;Henry Farman;0;0;0;16;2025-06-05 00:55:05;2025-06-05;0;Thursday
18011;Pajol - Place Herbert;38;22;16;1;2025-06-05 01:03:08;2025-06-05;1;Thursday
21212;Marne - Germain Dardan;4;2;2;15;2025-06-05 01:01:07;2025-06-05;1;Thursday
44006;Concorde - Stalingrad;33;19;14;1;2025-06-05 01:01:51;2025-06-05;1;Thursday
19120;Carducci - Place Hannah Arendt;15;1;14;12;2025-06-05 01:01:34;2025-06-05;1;Thursday
15104;Hôpital Européen Georges Pompidou;13;13;0;48;2025-06-05 01:01:34;2025-06-05;1;Thursday
19101;Square Simon Bolivar;8;4;4;16;2025-06-05 01:00:55;2025-06-05;1;Thursday
17204;Paul Bodin - Clichy;0;0;0;33;2024-10-08 08:49:38;2024-10-08;8;Tuesday
4016;Lobau - Hôtel de Ville;0;0;0;59;2025-06-05 01:02:27;2025-06-05;1;Thursday
41209;Cimetière de Fontenay-sous-Bois;7;1;6;8;2025-06-05 01:00:56;2025-06-05;1;Thursday
21312;Lucie Aubrac - Fort;6;0;6;24;2025-06-05 00:59:41;2025-06-05;0;Thursday
8017;Rocher - Laborde;0;0;0;65;2025-06-05 01:01:07;2025-06-05;1;Thursday
15054;Lecourbe - Jean Maridor;17;14;3;1;2025-06-05 01:02:07;2025-06-05;1;Thursday
22406;Guy Môquet - Etienne Dolet;14;5;9;8;2025-06-05 01:02:33;2025-06-05;1;Thursday
31102;Boissière - Etienne Dolet;10;3;7;11;2025-06-05 01:02:19;2025-06-05;1;Thursday
2111;Chabanais - Petits Champs;1;1;0;29;2025-06-05 01:02:52;2025-06-05;1;Thursday
21209;Molière - République;8;3;5;21;2025-06-05 01:02:23;2025-06-05;1;Thursday
21005;Hôtel de Ville de Boulogne Billancourt;15;14;1;11;2025-06-05 01:02:41;2025-06-05;1;Thursday
8045;Place de la Reine Astrid;6;4;2;51;2025-06-05 01:03:26;2025-06-05;1;Thursday
14124;David Weill - Parc Montsouris;10;2;8;12;2025-06-05 00:59:11;2025-06-05;0;Thursday
15133;Saint Lambert - Blomet;26;19;7;0;2025-06-05 01:03:00;2025-06-05;1;Thursday
15110;Place Robert Guillemard;13;11;2;10;2025-06-05 01:02:12;2025-06-05;1;Thursday
21006;Marcelin Berthelot;24;22;2;1;2025-06-05 01:03:24;2025-06-05;1;Thursday
20131;Repos - Cimetière du Père Lachaise;2;1;1;30;2025-06-05 00:57:33;2025-06-05;0;Thursday
44003;Gabriel Péri - Danielle Casanova;19;11;8;1;2025-06-05 01:03:27;2025-06-05;1;Thursday
48010;Karl Marx;3;1;2;13;2025-06-05 01:00:52;2025-06-05;1;Thursday
41202;Gare Rer de Fontenay sous Bois;41;32;9;18;2025-06-05 01:01:43;2025-06-05;1;Thursday
42021;Raspail - Manufacture des Oeillets;29;24;5;3;2025-06-05 01:03:24;2025-06-05;1;Thursday
35020;Marcelle - Thalie;2;0;2;17;2025-06-05 00:56:52;2025-06-05;0;Thursday
20115;Louis Lumière - Porte de Bagnolet;1;1;0;18;2025-06-04 18:03:15;2025-06-04;18;Wednesday
22402;Jean Jaurès - Salvador Allende;10;4;6;32;2025-06-05 00:57:49;2025-06-05;0;Thursday
6025;Assas - Rennes;0;0;0;32;2025-06-05 01:02:01;2025-06-05;1;Thursday
11039;Richard Lenoir - Jean-Pierre Timbaud;14;11;3;21;2025-06-05 01:03:33;2025-06-05;1;Thursday
11026;Chemin Vert - Saint-Maur;43;35;8;1;2025-06-05 01:02:19;2025-06-05;1;Thursday
32604;Square du Théâtre du Garde-Chasse;8;0;8;42;2025-06-05 00:59:30;2025-06-05;0;Thursday
41601;Général De Gaulle - Alouette;24;18;6;0;2025-06-05 01:03:05;2025-06-05;1;Thursday
17105;Place Madeleine Daniélou;11;11;0;31;2025-06-05 01:01:19;2025-06-05;1;Thursday
18009;Jean-François Lépine - Stephenson;14;4;10;8;2025-06-05 00:57:20;2025-06-05;0;Thursday
17125;Marie-Georges Picquart - Pereire;6;0;6;26;2025-06-05 01:00:46;2025-06-05;1;Thursday
43005;Gare RER de Vincennes;2;1;1;49;2025-06-05 01:00:09;2025-06-05;1;Thursday
16136;Théophile Gautier - François Millet;28;28;0;1;2025-06-05 01:02:24;2025-06-05;1;Thursday
22003;Beffroy;3;2;1;22;2025-06-05 01:02:36;2025-06-05;1;Thursday
11024;Mairie du 11ème;49;46;3;1;2025-06-05 01:03:13;2025-06-05;1;Thursday
22016;Charles de Gaulle - Sablonville;0;0;0;26;2025-06-05 00:58:26;2025-06-05;0;Thursday
14136;Auguste Cain - Jean Moulin;6;0;6;33;2025-06-05 01:00:20;2025-06-05;1;Thursday
15046;Parc Georges Brassens - Brancion;27;16;11;1;2025-06-05 01:02:26;2025-06-05;1;Thursday
16040;Exelmans - Michel-Ange;1;0;1;32;2025-06-05 01:00:41;2025-06-05;1;Thursday
22006;Pierret - Madrid;4;2;2;24;2025-06-05 00:59:12;2025-06-05;0;Thursday
17028;Reims - Raymond Pitet;3;1;2;33;2025-06-05 01:03:18;2025-06-05;1;Thursday
42302;Aristide Briand - Gare de Bagneux;16;8;8;6;2025-06-05 01:01:22;2025-06-05;1;Thursday
19029;Seine - Flandre;4;4;0;14;2025-06-05 00:58:37;2025-06-05;0;Thursday
9005;Square d'Anvers;0;0;0;32;2025-06-05 00:54:33;2025-06-05;0;Thursday
7102;Mairie du 7ème;7;1;6;41;2025-06-05 01:03:08;2025-06-05;1;Thursday
12204;Prague - Théophile Roussel;14;11;3;8;2025-06-05 01:01:36;2025-06-05;1;Thursday
20121;Boyer - Ménilmontant;5;0;5;14;2025-06-05 01:01:49;2025-06-05;1;Thursday
42301;Gare Arcueil - Cachan;11;6;5;14;2025-06-05 01:03:01;2025-06-05;1;Thursday
43003;Hôpital Bégin;0;0;0;24;2025-06-05 01:01:25;2025-06-05;1;Thursday
26013;Quai du docteur Dervaux;26;23;3;0;2025-06-05 01:02:50;2025-06-05;1;Thursday
15201;Place Amédée Gordini - Lefebvre;28;8;20;10;2025-06-05 00:58:25;2025-06-05;0;Thursday
19008;Flandre - Alphonse Karr;8;2;6;15;2025-06-05 00:58:00;2025-06-05;0;Thursday
11004;Charonne - Faubourg Saint-Antoine;11;6;5;20;2025-06-05 00:56:48;2025-06-05;0;Thursday
18201;Tristan Tzara -  Tchaïkovski;13;3;10;18;2025-06-05 01:01:29;2025-06-05;1;Thursday
51004;Général Delambre - Prebuard;14;6;8;15;2025-06-05 00:55:59;2025-06-05;0;Thursday
14036;Boulard - Daguerre;18;1;17;25;2025-06-05 01:03:13;2025-06-05;1;Thursday
12009;Charenton - Diderot;14;10;4;2;2025-06-05 00:58:57;2025-06-05;0;Thursday
5123;Saint-Germain - Thenard;1;1;0;30;2025-06-05 00:57:03;2025-06-05;0;Thursday
21313;Guynemer - Séverine;23;19;4;2;2025-06-05 01:01:43;2025-06-05;1;Thursday
28001;Richard Wallace - Place du 8 Mai 1945;23;17;6;6;2025-06-05 00:58:09;2025-06-05;0;Thursday
26007;Square Gilbert Thomain;18;7;11;1;2025-06-05 00:59:16;2025-06-05;0;Thursday
19005;Flandre - Riquet;15;7;8;5;2025-06-05 00:58:23;2025-06-05;0;Thursday
41606;Pasteur - Gambetta;4;2;2;13;2025-06-05 00:58:22;2025-06-05;0;Thursday
17011;Fragonard - Porte de Clichy;25;11;14;29;2025-06-05 01:03:01;2025-06-05;1;Thursday
7015;Varenne;1;0;1;45;2025-06-05 00:57:14;2025-06-05;0;Thursday
5021;Jussieu - Fossés Saint-Bernard;4;3;1;30;2025-06-05 01:01:56;2025-06-05;1;Thursday
6013;Jacques Callot - Mazarine;1;1;0;27;2025-06-05 01:01:49;2025-06-05;1;Thursday
21305;Place Jacques Madaule;22;20;2;1;2025-06-05 01:02:08;2025-06-05;1;Thursday
16121;Jardin d'Acclimatation;5;3;2;27;2025-06-05 00:59:47;2025-06-05;0;Thursday
23001;Paul Vaillant Couturier - Chaptal;15;4;11;23;2025-06-05 01:00:22;2025-06-05;1;Thursday
18141;Clignancourt - Sofia;4;1;3;12;2025-06-05 01:01:07;2025-06-05;1;Thursday
33003;Bordier - Félix Faure;35;18;17;13;2025-06-05 01:02:25;2025-06-05;1;Thursday
33009;Félix Faure - Sadi Carnot;16;11;5;15;2025-06-05 01:02:48;2025-06-05;1;Thursday
5106;Cujas - Saint-Michel;1;0;1;18;2025-06-05 00:58:27;2025-06-05;0;Thursday
25005;18 juin 1940 - Buzenval;10;4;6;14;2025-06-05 01:00:07;2025-06-05;1;Thursday
13045;Jean Colly - Tolbiac;26;20;6;9;2025-06-05 01:00:33;2025-06-05;1;Thursday
19115;Porte de la Villette;3;1;2;22;2025-06-05 00:56:33;2025-06-05;0;Thursday
14034;Ouest - Château;8;2;6;14;2025-06-05 01:02:34;2025-06-05;1;Thursday
32010;Place aux Étoiles;2;0;2;38;2025-06-05 01:00:14;2025-06-05;1;Thursday
25008;Place du 8 Mai 1945;2;2;0;16;2025-06-05 00:57:33;2025-06-05;0;Thursday
19044;Grands Moulins de Pantin;4;3;1;46;2025-06-05 00:57:14;2025-06-05;0;Thursday
20132;Réunion - Avron;11;2;9;14;2025-06-05 01:02:05;2025-06-05;1;Thursday
42707;Place Jean-Baptiste Clément;14;6;8;10;2025-06-05 01:00:57;2025-06-05;1;Thursday
5119;Jussieu - Guy de la Brosse;2;2;0;36;2025-06-05 00:58:45;2025-06-05;0;Thursday
27002;Parc Pierre Lagravère;25;21;4;3;2025-06-05 01:00:57;2025-06-05;1;Thursday
21109;Guichet - Jean Jaurès;25;18;7;2;2025-06-05 01:01:29;2025-06-05;1;Thursday
21502;Verdun - Place Henri IV;24;19;5;0;2025-06-05 01:01:43;2025-06-05;1;Thursday
35019;Anatole France - Jean Lolive;27;9;18;0;2025-06-05 01:00:06;2025-06-05;1;Thursday
14104;Boyer-Barret - Raymond Losserand;12;4;8;11;2025-06-05 01:01:17;2025-06-05;1;Thursday
20113;Piat - Parc de Belleville;0;0;0;21;2025-06-05 00:55:57;2025-06-05;0;Thursday
20119;Square des Saint-Simoniens;5;1;4;20;2025-06-05 01:02:45;2025-06-05;1;Thursday
20036;Ménilmontant - Pelleport;5;0;5;27;2025-06-05 01:02:54;2025-06-05;1;Thursday
19019;Petit - Manin;7;2;5;12;2025-06-05 01:03:29;2025-06-05;1;Thursday
41604;Lagny - Joffre;3;2;1;25;2025-06-05 01:00:27;2025-06-05;1;Thursday
15017;Place Falguière;9;3;6;14;2025-06-05 01:03:02;2025-06-05;1;Thursday
18005;Tardieu - Chappe;2;1;1;16;2025-06-05 01:01:35;2025-06-05;1;Thursday
26001;Gare d'Asnières sur Seine;21;17;4;2;2025-06-05 01:01:59;2025-06-05;1;Thursday
20136;Henri Chevreau - Couronnes;7;3;4;20;2025-06-05 00:58:56;2025-06-05;0;Thursday
5026;Pascal - Claude Bernard;37;31;6;11;2025-06-05 01:02:27;2025-06-05;1;Thursday
8102;Lamennais - Washington;5;1;4;21;2025-06-05 00:56:04;2025-06-05;0;Thursday
31702;Pierre et Marie Curie - Julien Grimau;9;0;9;9;2025-06-05 00:59:44;2025-06-05;0;Thursday
7004;Raspail - Varenne;1;1;0;17;2025-06-05 01:02:53;2025-06-05;1;Thursday
21111;Professeur René Leriche - Général Leclerc;33;24;9;17;2025-06-05 00:59:50;2025-06-05;0;Thursday
2010;Uzès - Montmartre;1;0;1;28;2025-06-05 00:55:46;2025-06-05;0;Thursday
11114;Ledru-Rollin - Charonne;24;19;5;7;2025-06-05 01:02:09;2025-06-05;1;Thursday
5116;Place Valhubert;5;1;4;45;2025-06-05 01:02:58;2025-06-05;1;Thursday
20040;Parc de Belleville - Julien Lacroix;5;1;4;21;2025-06-05 00:59:22;2025-06-05;0;Thursday
17017;Gare de Pont-Cardinet;11;9;2;22;2025-06-05 01:03:04;2025-06-05;1;Thursday
10023;Gare de l'Est - Verdun;3;2;1;11;2025-06-05 00:58:03;2025-06-05;0;Thursday
34002;Capitaine Glarner - Gabriel Péri;24;19;5;1;2025-06-05 01:03:03;2025-06-05;1;Thursday
14139;Pierre Larousse - Raymond Losserand;12;9;3;16;2025-06-05 01:02:27;2025-06-05;1;Thursday
11101;Charles Delescluze;44;42;2;5;2025-06-05 01:03:10;2025-06-05;1;Thursday
15055;Vasco de Gama;47;43;4;2;2025-06-05 01:03:26;2025-06-05;1;Thursday
14130;Jonquoy - Didot;25;10;15;5;2025-06-05 01:01:58;2025-06-05;1;Thursday
41207;Place du Général de Gaulle;1;1;0;25;2025-06-05 01:02:53;2025-06-05;1;Thursday
19037;Belleville - Porte des Lilas;1;0;1;28;2025-06-05 01:01:08;2025-06-05;1;Thursday
20021;Indre - Prairies;3;0;3;33;2025-06-05 01:02:47;2025-06-05;1;Thursday
21105;Morice - Général Leclerc;23;17;6;1;2025-06-05 01:03:08;2025-06-05;1;Thursday
19109;Tanger - Place du Maroc;11;5;6;8;2025-06-05 00:59:31;2025-06-05;0;Thursday
18032;Porte de Clignancourt.;6;2;4;49;2025-06-05 00:57:13;2025-06-05;0;Thursday
44012;Génie - Mozart;5;0;5;14;2025-06-05 01:00:40;2025-06-05;1;Thursday
13016;Primo Levi - Frigos;5;3;2;29;2025-06-05 01:01:02;2025-06-05;1;Thursday
13043;Dunois - Clisson;18;17;1;32;2025-06-05 01:02:41;2025-06-05;1;Thursday
8051;Batignolles - Rome;2;0;2;11;2025-06-05 00:57:27;2025-06-05;0;Thursday
9115;Milton - Manuel;4;2;2;18;2025-06-05 01:02:41;2025-06-05;1;Thursday
21003;Jean Jaurès - Jean Baptiste Clément;29;27;2;7;2025-06-05 01:00:28;2025-06-05;1;Thursday
22001;Château - Bineau;7;3;4;16;2025-06-05 01:02:09;2025-06-05;1;Thursday
17122;Bridaine - Lamandé;11;5;6;18;2025-06-05 01:02:40;2025-06-05;1;Thursday
14122;Colonel Monteil - Brune;6;2;4;12;2025-06-05 00:56:18;2025-06-05;0;Thursday
16123;Mahatma Gandhi;4;1;3;22;2025-06-05 00:59:15;2025-06-05;0;Thursday
31007;Paris - Désiré Préaux;3;0;3;44;2025-06-05 00:55:50;2025-06-05;0;Thursday
15108;Lourmel - Marie Skobtsov;19;18;1;1;2025-06-05 00:59:37;2025-06-05;0;Thursday
19040;Belleville - Télégraphe;9;1;8;32;2025-06-05 01:02:49;2025-06-05;1;Thursday
41204;République - Danton;12;3;9;7;2025-06-05 01:02:13;2025-06-05;1;Thursday
17046;Mac-Mahon - Brey;3;2;1;22;2025-06-05 00:59:02;2025-06-05;0;Thursday
19009;Cité des Sciences et de l'Industrie;3;0;3;21;2025-06-05 00:59:10;2025-06-05;0;Thursday
21703;Square du Carrefour de l'Insurrection;15;10;5;6;2025-06-05 00:54:25;2025-06-05;0;Thursday
16021;François Ponsard - La Muette;3;1;2;19;2025-06-05 00:51:32;2025-06-05;0;Thursday
9117;Bellefond - Maubeuge;4;1;3;26;2025-06-05 00:59:34;2025-06-05;0;Thursday
14002;Edgar Quinet - Raspail;17;3;14;29;2025-06-05 00:56:28;2025-06-05;0;Thursday
15035;Place Etienne Pernet;42;37;5;0;2025-06-05 01:03:06;2025-06-05;1;Thursday
10020;Chabrol - d'Hauteville;8;1;7;2;2025-06-05 01:02:01;2025-06-05;1;Thursday
11041;Square Saint-Ambroise;32;24;8;8;2025-06-05 01:02:14;2025-06-05;1;Thursday
15031;Théâtre - Lourmel;53;51;2;0;2025-06-05 01:03:17;2025-06-05;1;Thursday
11006;Ledru-Rollin - Place du Père Chaillet;33;26;7;3;2025-06-05 01:03:18;2025-06-05;1;Thursday
47005;Ecole Vétérinaire;32;31;1;0;2025-06-05 01:03:09;2025-06-05;1;Thursday
14112;Méchain - Faubourg Saint-Jacques;2;1;1;13;2025-06-05 01:00:37;2025-06-05;1;Thursday
11010;Boulets - Faubourg Saint-Antoine;24;17;7;17;2025-06-05 01:01:07;2025-06-05;1;Thursday
23007;Président Wilson - Jean Jaures;11;7;4;15;2025-06-05 01:01:50;2025-06-05;1;Thursday
20016;Pyrénées - Maraîchers;17;2;15;16;2025-06-05 01:02:06;2025-06-05;1;Thursday
32015;Gare RER de Saint-Denis;21;10;11;13;2025-06-05 01:03:30;2025-06-05;1;Thursday
10010;Place Jacques Bonsergent;24;20;4;7;2025-06-05 01:03:21;2025-06-05;1;Thursday
16043;Place de Passy;2;0;2;13;2025-06-05 01:02:22;2025-06-05;1;Thursday
16027;Mozart - Jasmin;10;8;2;52;2025-06-05 01:00:45;2025-06-05;1;Thursday
6107;Place Alphonse Deville;2;2;0;20;2025-06-05 00:55:09;2025-06-05;0;Thursday
