station_id;name;numbikesavailable;mechanical;ebike;numdocksavailable;timestamp;date;hour;weekday
16107;Benjamin Godard - Victor Hugo;2;2;0;33;2025-06-05 10:03:56;2025-06-05;10;Thursday
40001;Hôpital Mondor;20;13;7;7;2025-06-05 10:03:14;2025-06-05;10;Thursday
44015;Rouget de L'isle - Watteau;15;6;9;5;2025-06-05 10:04:27;2025-06-05;10;Thursday
14014;Jourdan - Stade Charléty;4;2;2;54;2025-06-05 10:04:14;2025-06-05;10;Thursday
32017;Basilique;4;3;1;18;2025-06-05 10:01:22;2025-06-05;10;Thursday
11104;Charonne - Robert et Sonia Delaunay;0;0;0;20;2025-06-05 10:01:47;2025-06-05;10;Thursday
7002;Vaneau - Sèvres;2;2;0;30;2025-06-05 10:04:36;2025-06-05;10;Thursday
5110;Lacépède - Monge;5;1;4;18;2025-06-05 10:03:33;2025-06-05;10;Thursday
33006;André Karman - République;14;10;4;13;2025-06-05 10:02:47;2025-06-05;10;Thursday
40011;Bas du Mont-Mesly;27;16;11;0;2025-06-05 09:59:44;2025-06-05;9;Thursday
11025;Froment - Bréguet;16;14;2;26;2025-06-05 10:04:30;2025-06-05;10;Thursday
17026;Jouffroy d'Abbans - Wagram;6;1;5;33;2025-06-05 10:04:31;2025-06-05;10;Thursday
12109;Mairie du 12ème;9;5;4;20;2025-06-05 09:58:42;2025-06-05;9;Thursday
8050;Boétie - Ponthieu;40;21;19;3;2025-06-05 10:04:26;2025-06-05;10;Thursday
31024;Romainville - Vaillant-Couturier;1;0;1;37;2025-06-05 10:02:03;2025-06-05;10;Thursday
40016;Sarrazins - Saussure;0;0;0;22;2025-02-05 10:35:03;2025-02-05;10;Wednesday
17044;Porte de Saint-Ouen - Bessières;2;2;0;39;2025-06-05 10:02:19;2025-06-05;10;Thursday
19033;Cambrai - Benjamin Constant;7;2;5;35;2025-06-05 10:01:51;2025-06-05;10;Thursday
17025;Chazelles - Courcelles;4;1;3;29;2025-06-05 10:04:15;2025-06-05;10;Thursday
21326;Moulin de Pierre - Abbé Grégoire;4;0;4;16;2025-06-05 09:54:37;2025-06-05;9;Thursday
20143;Ramponeau - Belleville;3;1;2;41;2025-06-05 09:59:41;2025-06-05;9;Thursday
16138;Saint-Cloud - Hippodrome;4;3;1;25;2025-06-05 10:02:44;2025-06-05;10;Thursday
21216;Louis Lejeune - Barbès;1;1;0;24;2025-06-05 09:59:01;2025-06-05;9;Thursday
15068;Général Martial Valin - Pont du Garigliano;9;7;2;6;2025-06-05 10:03:47;2025-06-05;10;Thursday
22207;Rond-point du Dr Albert Schweitzer;2;0;2;20;2025-06-05 10:00:40;2025-06-05;10;Thursday
17048;De Toqueville - Terrasse;5;2;3;23;2025-06-05 09:59:36;2025-06-05;9;Thursday
44017;Jules Guesde - Pont du Port à l'Anglais;25;21;4;3;2025-06-05 10:04:17;2025-06-05;10;Thursday
44010;8 Mai 1945 - 10 Juillet 1940;24;17;7;5;2025-06-05 10:01:40;2025-06-05;10;Thursday
9008;Tour d'Auvergne - Rodier;0;0;0;16;2025-06-05 10:03:45;2025-06-05;10;Thursday
13030;Italie - Tolbiac;3;0;3;16;2025-06-05 10:04:34;2025-06-05;10;Thursday
19027;Serrurier;0;0;0;0;2025-05-21 06:48:59;2025-05-21;6;Wednesday
18111;Félix Ziem - Armand Gauthier;1;0;1;23;2025-06-05 10:00:43;2025-06-05;10;Thursday
9002;Abbeville - Faubourg Poissonnière;0;0;0;12;2025-06-05 10:04:36;2025-06-05;10;Thursday
48003;Youri Gagarine - Karl Marx;2;2;0;19;2025-06-05 09:55:23;2025-06-05;9;Thursday
43009;Place Jean-Spire-Lemaître;2;2;0;48;2025-06-05 10:00:55;2025-06-05;10;Thursday
17032;Jean Oestreicher - Porte de Champerret;6;5;1;15;2025-06-05 10:03:54;2025-06-05;10;Thursday
8016;Square Louis XVI;20;16;4;6;2025-06-05 10:01:59;2025-06-05;10;Thursday
10115;Granges aux Belles;1;0;1;25;2025-06-05 10:00:22;2025-06-05;10;Thursday
10161;Gare de l'Est - Faubourg-Saint-Martin;0;0;0;32;2025-06-05 10:02:06;2025-06-05;10;Thursday
41303;Gare de Nogent-le-Perreux;23;22;1;9;2025-06-05 10:03:58;2025-06-05;10;Thursday
12031;Gabriel Lamé;31;29;2;2;2025-06-05 10:03:06;2025-06-05;10;Thursday
1001;Quai de l'Horloge - Pont Neuf;14;10;4;3;2025-06-05 09:59:11;2025-06-05;9;Thursday
13104;Gare d'Austerlitz - Quai Saint-Bernard;11;8;3;16;2025-06-05 09:58:01;2025-06-05;9;Thursday
31103;Gare Rosny-Bois-Perrier;16;7;9;18;2025-06-05 09:59:51;2025-06-05;9;Thursday
8053;Place Georges Guillaumin;25;9;16;4;2025-06-05 10:02:06;2025-06-05;10;Thursday
9014;Faubourg Montmartre - La Fayette;10;8;2;24;2025-06-05 10:03:41;2025-06-05;10;Thursday
19105;Ambroise Rendu - Porte Brunet;2;1;1;14;2025-06-05 10:01:23;2025-06-05;10;Thursday
22409;Henri Barbusse - Stalingrad;1;0;1;13;2025-06-05 10:01:18;2025-06-05;10;Thursday
19015;Thionville - Ourcq;1;1;0;23;2025-06-05 10:04:09;2025-06-05;10;Thursday
17004;Legendre - Clichy;3;3;0;37;2025-06-05 10:03:51;2025-06-05;10;Thursday
19003;Quai de la Seine;3;1;2;21;2025-06-05 09:56:43;2025-06-05;9;Thursday
12151;Gare de Lyon - Place Louis Armand;57;46;11;3;2025-06-05 10:03:46;2025-06-05;10;Thursday
16026;Ranelagh - Mozart;1;0;1;7;2025-06-05 09:59:11;2025-06-05;9;Thursday
17043;Belidor - Gouvion-Saint-Cyr;5;4;1;34;2025-06-05 09:59:23;2025-06-05;9;Thursday
19026;Place de Rhin et Danube;2;0;2;13;2025-06-05 10:01:01;2025-06-05;10;Thursday
16039;Exelmans - Versailles;5;3;2;43;2025-06-05 10:04:34;2025-06-05;10;Thursday
11023;Saint-Maur - Roquette;3;2;1;41;2025-06-05 10:02:15;2025-06-05;10;Thursday
45003;11 Novembre 1918 - 8 Mai 1945;8;7;1;28;2025-06-05 10:02:02;2025-06-05;10;Thursday
11002;Roquette - Thiéré;6;1;5;15;2025-06-05 09:58:34;2025-06-05;9;Thursday
12111;Claude Decaen - Cannebière;5;2;3;40;2025-06-05 10:02:05;2025-06-05;10;Thursday
5032;Panthéon - Valette;35;2;33;2;2025-06-05 10:04:25;2025-06-05;10;Thursday
15067;Desaix - Edgar Faure;7;0;7;4;2025-06-05 10:02:31;2025-06-05;10;Thursday
17030;Pereire - Rennequin;2;0;2;20;2025-06-05 10:01:47;2025-06-05;10;Thursday
12128;Pyramide - Ecole du Breuil;13;10;3;21;2025-06-05 10:02:01;2025-06-05;10;Thursday
31022;Mairie de Montreuil;6;5;1;45;2025-06-05 10:01:21;2025-06-05;10;Thursday
46002;Rouget de Lisle;14;10;4;20;2025-06-05 10:04:28;2025-06-05;10;Thursday
31009;Place Du Général De Gaulle;2;0;2;24;2025-06-05 09:56:39;2025-06-05;9;Thursday
41302;Charles de Gaulle - Beauté;1;0;1;48;2025-06-05 10:04:18;2025-06-05;10;Thursday
33017;Anatole France - President Roosevelt;7;5;2;21;2025-06-05 10:04:24;2025-06-05;10;Thursday
21212;Marne - Germain Dardan;3;0;3;16;2025-06-05 10:04:27;2025-06-05;10;Thursday
44006;Concorde - Stalingrad;7;4;3;26;2025-06-05 10:03:30;2025-06-05;10;Thursday
11113;Richard Lenoir - Republique;7;5;2;51;2025-06-05 10:02:44;2025-06-05;10;Thursday
15104;Hôpital Européen Georges Pompidou;59;56;3;3;2025-06-05 10:03:09;2025-06-05;10;Thursday
14003;Schoelcher - Raspail;1;0;1;49;2025-06-05 09:58:33;2025-06-05;9;Thursday
43008;Fontenay - Libération;4;3;1;21;2025-06-05 10:01:13;2025-06-05;10;Thursday
5018;Mutualité;10;5;5;24;2025-06-05 10:02:00;2025-06-05;10;Thursday
19101;Square Simon Bolivar;0;0;0;24;2025-06-05 10:03:35;2025-06-05;10;Thursday
21312;Lucie Aubrac - Fort;3;0;3;27;2025-06-05 10:03:51;2025-06-05;10;Thursday
13001;Port-Royal - Hôpital du Val-de-Grâce;5;1;4;13;2025-06-05 10:01:24;2025-06-05;10;Thursday
5124;Erasme - Ulm;19;7;12;5;2025-06-05 10:03:15;2025-06-05;10;Thursday
14106;Marc Sangnier - Porte de Vanves;2;1;1;19;2025-06-05 09:58:43;2025-06-05;9;Thursday
31102;Boissière - Etienne Dolet;3;1;2;18;2025-06-05 10:02:22;2025-06-05;10;Thursday
2111;Chabanais - Petits Champs;23;15;8;7;2025-06-05 10:03:48;2025-06-05;10;Thursday
15109;Cevennes - Bergers;4;2;2;25;2025-06-05 10:00:30;2025-06-05;10;Thursday
21209;Molière - République;1;0;1;29;2025-06-05 10:04:00;2025-06-05;10;Thursday
14012;Sibelle - Alésia;1;0;1;36;2025-06-05 10:03:25;2025-06-05;10;Thursday
10042;Enghien - Faubourg Poissonnière;17;10;7;14;2025-06-05 10:00:05;2025-06-05;10;Thursday
19103;Manin - Carrières d'Amérique;1;0;1;17;2025-06-05 09:59:19;2025-06-05;9;Thursday
17203;Place de la Porte de Champeret;2;2;0;26;2025-06-05 10:02:49;2025-06-05;10;Thursday
42014;Place Marcel Cachin;22;22;0;10;2025-06-05 10:04:23;2025-06-05;10;Thursday
15133;Saint Lambert - Blomet;3;1;2;24;2025-06-05 09:57:20;2025-06-05;9;Thursday
16202;Commandant Schloesing - Pétrarque;0;0;0;30;2025-05-23 15:36:48;2025-05-23;15;Friday
44013;Edouard Tremblay - Julian Grimaux;10;9;1;17;2025-06-05 10:01:47;2025-06-05;10;Thursday
21015;Nationale - Place Jules Guesde;9;8;1;12;2025-06-05 10:03:48;2025-06-05;10;Thursday
44003;Gabriel Péri - Danielle Casanova;7;7;0;13;2025-06-05 09:58:34;2025-06-05;9;Thursday
15034;Lakanal - Commerce;47;43;4;2;2025-06-05 10:04:30;2025-06-05;10;Thursday
5028;Censier - Jardin des Plantes;19;16;3;6;2025-06-05 10:03:38;2025-06-05;10;Thursday
22203;Tertres - Fontaine;8;7;1;20;2025-06-05 09:55:36;2025-06-05;9;Thursday
42021;Raspail - Manufacture des Oeillets;23;20;3;9;2025-06-05 10:03:55;2025-06-05;10;Thursday
1119;Cossonnerie - Sébastopol;16;9;7;8;2025-06-05 10:04:08;2025-06-05;10;Thursday
35020;Marcelle - Thalie;0;0;0;19;2025-06-05 10:01:21;2025-06-05;10;Thursday
1020;Cambon - Rivoli;34;16;18;3;2025-06-05 10:04:18;2025-06-05;10;Thursday
20115;Louis Lumière - Porte de Bagnolet;2;1;1;18;2025-06-05 10:00:28;2025-06-05;10;Thursday
31003;Paris - Emile Zola;13;11;2;17;2025-06-05 10:04:11;2025-06-05;10;Thursday
22402;Jean Jaurès - Salvador Allende;3;2;1;40;2025-06-05 10:01:46;2025-06-05;10;Thursday
9116;Victoire - Chaussée d'Antin;18;12;6;5;2025-06-05 10:03:26;2025-06-05;10;Thursday
11030;Oberkampf - République;1;1;0;23;2025-06-05 10:03:32;2025-06-05;10;Thursday
11039;Richard Lenoir - Jean-Pierre Timbaud;3;1;2;32;2025-06-05 10:02:45;2025-06-05;10;Thursday
17013;Legendre - Dulong;4;1;3;19;2025-06-05 09:59:10;2025-06-05;9;Thursday
32604;Square du Théâtre du Garde-Chasse;0;0;0;50;2025-06-05 10:03:32;2025-06-05;10;Thursday
19024;Botzaris - Parc des Buttes Chaumont;0;0;0;20;2025-06-05 10:03:17;2025-06-05;10;Thursday
23006;Jules Guesde - Alsace;21;11;10;4;2025-06-05 10:03:35;2025-06-05;10;Thursday
17105;Place Madeleine Daniélou;10;5;5;31;2025-06-05 10:03:50;2025-06-05;10;Thursday
18009;Jean-François Lépine - Stephenson;6;1;5;15;2025-06-05 10:00:27;2025-06-05;10;Thursday
16108;Sablons - Georges Mandel;1;0;1;37;2025-06-05 09:58:35;2025-06-05;9;Thursday
22003;Beffroy;18;11;7;6;2025-06-05 10:03:30;2025-06-05;10;Thursday
13050;Quai Panhard et Levassor;55;47;8;1;2025-06-05 10:03:41;2025-06-05;10;Thursday
22016;Charles de Gaulle - Sablonville;8;3;5;18;2025-06-05 10:03:39;2025-06-05;10;Thursday
14136;Auguste Cain - Jean Moulin;1;0;1;38;2025-06-05 10:04:09;2025-06-05;10;Thursday
10014;Marseille - Beaurepaire;15;14;1;40;2025-06-05 10:04:12;2025-06-05;10;Thursday
11035;Parmentier - Abel Rabaud;2;0;2;46;2025-06-05 10:02:29;2025-06-05;10;Thursday
16040;Exelmans - Michel-Ange;18;7;11;14;2025-06-05 10:03:00;2025-06-05;10;Thursday
22006;Pierret - Madrid;19;13;6;9;2025-06-05 10:03:29;2025-06-05;10;Thursday
21301;Saint-Vincent - Verdun;21;21;0;11;2025-06-05 10:04:09;2025-06-05;10;Thursday
42302;Aristide Briand - Gare de Bagneux;4;1;3;18;2025-06-05 09:56:35;2025-06-05;9;Thursday
19016;Hautpoul - Jean Jaurès;2;1;1;29;2025-06-05 10:01:34;2025-06-05;10;Thursday
32026;Leroy des Barres - Médiathèque;22;18;4;3;2025-06-05 10:04:20;2025-06-05;10;Thursday
9005;Square d'Anvers;1;0;1;31;2025-06-05 09:58:45;2025-06-05;9;Thursday
8025;Miromesnil - La Boétie;26;20;6;8;2025-06-05 10:03:14;2025-06-05;10;Thursday
12204;Prague - Théophile Roussel;6;4;2;16;2025-06-05 10:03:45;2025-06-05;10;Thursday
20121;Boyer - Ménilmontant;1;0;1;18;2025-06-05 09:56:20;2025-06-05;9;Thursday
42301;Gare Arcueil - Cachan;6;4;2;18;2025-06-05 10:04:19;2025-06-05;10;Thursday
43003;Hôpital Bégin;13;9;4;11;2025-06-05 10:04:35;2025-06-05;10;Thursday
42504;Gare RER de Gentilly;2;1;1;28;2025-06-05 10:01:28;2025-06-05;10;Thursday
20111;Villiers de l'Isle Adam - Pyrénées;1;0;1;19;2025-06-05 10:04:22;2025-06-05;10;Thursday
42015;Place Jean Ferrat;1;0;1;24;2025-06-05 09:59:45;2025-06-05;9;Thursday
31010;Stalingrad - Désiré Chevalier;2;1;1;40;2025-06-05 10:02:58;2025-06-05;10;Thursday
19008;Flandre - Alphonse Karr;5;2;3;18;2025-06-05 10:04:17;2025-06-05;10;Thursday
11004;Charonne - Faubourg Saint-Antoine;30;27;3;2;2025-06-05 10:04:30;2025-06-05;10;Thursday
92008;Hôtel de Ville de Nanterre;9;8;1;28;2025-06-05 10:00:27;2025-06-05;10;Thursday
51004;Général Delambre - Prebuard;14;6;8;15;2025-06-05 10:03:54;2025-06-05;10;Thursday
18012;Stephenson - Doudeauville;3;2;1;33;2025-06-05 09:55:00;2025-06-05;9;Thursday
19125;Place de l'Édit de Nantes;3;0;3;22;2025-06-05 10:00:50;2025-06-05;10;Thursday
5123;Saint-Germain - Thenard;7;4;3;24;2025-06-05 10:02:58;2025-06-05;10;Thursday
11036;Jules Ferry - Faubourg du Temple Paris;5;4;1;49;2025-06-05 10:03:56;2025-06-05;10;Thursday
21313;Guynemer - Séverine;22;20;2;3;2025-06-05 10:00:03;2025-06-05;10;Thursday
26007;Square Gilbert Thomain;15;8;7;4;2025-06-05 09:59:33;2025-06-05;9;Thursday
11007;Jean Macé - Faidherbe;18;13;5;43;2025-06-05 10:04:20;2025-06-05;10;Thursday
15025;Dupleix - du Guesclin;27;25;2;19;2025-06-05 10:04:32;2025-06-05;10;Thursday
35018;Ancien Canal - Hélène Brion;17;14;3;5;2025-06-05 10:02:34;2025-06-05;10;Thursday
10113;Parmentier - Hôpital Saint-Louis;2;0;2;39;2025-06-05 10:03:57;2025-06-05;10;Thursday
17011;Fragonard - Porte de Clichy;28;22;6;24;2025-06-05 10:02:40;2025-06-05;10;Thursday
17045;Place des Ternes.;19;14;5;26;2025-06-05 10:03:58;2025-06-05;10;Thursday
12013;Montgallet - Reuilly;3;2;1;12;2025-06-05 09:57:36;2025-06-05;9;Thursday
11115;Montreuil - Gonnet;6;4;2;18;2025-06-05 10:02:58;2025-06-05;10;Thursday
7015;Varenne;22;15;7;24;2025-06-05 10:01:54;2025-06-05;10;Thursday
6013;Jacques Callot - Mazarine;27;18;9;1;2025-06-05 10:00:27;2025-06-05;10;Thursday
32303;Gaston Roussel - Commune de Paris;0;0;0;0;2018-08-13 06:11:15;2018-08-13;6;Monday
8033;Commandant Rivière;39;31;8;3;2025-06-05 10:04:36;2025-06-05;10;Thursday
16121;Jardin d'Acclimatation;17;11;6;14;2025-06-05 10:04:31;2025-06-05;10;Thursday
17037;Bayen - Pereire;2;1;1;19;2025-06-05 10:02:27;2025-06-05;10;Thursday
33003;Bordier - Félix Faure;14;11;3;34;2025-06-05 10:03:19;2025-06-05;10;Thursday
33009;Félix Faure - Sadi Carnot;22;19;3;10;2025-06-05 10:04:11;2025-06-05;10;Thursday
25005;18 juin 1940 - Buzenval;4;0;4;20;2025-06-05 10:01:27;2025-06-05;10;Thursday
14034;Ouest - Château;2;0;2;21;2025-06-05 10:00:02;2025-06-05;10;Thursday
32010;Place aux Étoiles;30;7;23;10;2025-06-05 10:04:11;2025-06-05;10;Thursday
24002;Gare de Courbevoie;7;2;5;27;2025-06-05 10:03:49;2025-06-05;10;Thursday
16034;Porte d'Auteuil;11;5;6;22;2025-06-05 10:01:13;2025-06-05;10;Thursday
7009;Assemblée Nationale;51;32;19;24;2025-06-05 10:01:38;2025-06-05;10;Thursday
42707;Place Jean-Baptiste Clément;2;0;2;22;2025-06-05 10:00:54;2025-06-05;10;Thursday
35009;Jean Lolive - Parc Stalingrad;3;1;2;17;2025-06-05 10:04:15;2025-06-05;10;Thursday
8055;Courcelles - Place des Ternes;2;0;2;29;2025-06-04 15:13:27;2025-06-04;15;Wednesday
21109;Guichet - Jean Jaurès;8;5;3;19;2025-06-05 10:02:14;2025-06-05;10;Thursday
23701;Parvis Robert Schuman - Roger Salengro;8;4;4;14;2025-06-05 09:59:55;2025-06-05;9;Thursday
17007;Navier - Epinettes;4;0;4;50;2025-06-05 09:58:34;2025-06-05;9;Thursday
21502;Verdun - Place Henri IV;25;21;4;0;2025-06-05 10:03:01;2025-06-05;10;Thursday
35019;Anatole France - Jean Lolive;15;11;4;12;2025-06-05 10:03:11;2025-06-05;10;Thursday
20113;Piat - Parc de Belleville;1;0;1;20;2025-06-05 10:00:19;2025-06-05;10;Thursday
20119;Square des Saint-Simoniens;2;0;2;23;2025-06-05 09:56:48;2025-06-05;9;Thursday
19019;Petit - Manin;4;0;4;15;2025-06-05 10:00:17;2025-06-05;10;Thursday
15017;Place Falguière;2;0;2;21;2025-06-05 09:57:18;2025-06-05;9;Thursday
17018;Parc Monceau;9;6;3;8;2025-06-05 09:59:11;2025-06-05;9;Thursday
18005;Tardieu - Chappe;0;0;0;18;2025-06-05 10:04:12;2025-06-05;10;Thursday
26001;Gare d'Asnières sur Seine;19;18;1;4;2025-06-05 10:04:31;2025-06-05;10;Thursday
92004;Nanterre - Université;3;2;1;17;2025-06-05 09:58:02;2025-06-05;9;Thursday
20136;Henri Chevreau - Couronnes;1;0;1;26;2025-06-05 09:57:45;2025-06-05;9;Thursday
5026;Pascal - Claude Bernard;6;4;2;42;2025-06-05 10:04:36;2025-06-05;10;Thursday
5002;Sommerard - Saint-Jacques;31;24;7;3;2025-06-05 10:03:57;2025-06-05;10;Thursday
14018;Porte d'Orléans;6;3;3;40;2025-06-05 10:00:55;2025-06-05;10;Thursday
31702;Pierre et Marie Curie - Julien Grimau;0;0;0;18;2025-06-05 09:58:50;2025-06-05;9;Thursday
21111;Professeur René Leriche - Général Leclerc;33;32;1;17;2025-06-05 10:01:08;2025-06-05;10;Thursday
2010;Uzès - Montmartre;22;12;10;7;2025-06-05 10:00:56;2025-06-05;10;Thursday
7006;Quai Voltaire;30;24;6;1;2025-06-05 10:04:31;2025-06-05;10;Thursday
8012;Batignolles - Place de Clichy;5;1;4;40;2025-06-05 10:01:43;2025-06-05;10;Thursday
34002;Capitaine Glarner - Gabriel Péri;8;2;6;16;2025-06-05 10:04:07;2025-06-05;10;Thursday
13026;Place Jean Delay;1;0;1;31;2025-06-05 09:59:46;2025-06-05;9;Thursday
13102;Pitié-Salpêtrière;29;16;13;22;2025-06-05 10:03:20;2025-06-05;10;Thursday
10015;Lucien Sampaix - Récollets;2;0;2;44;2025-06-05 10:03:53;2025-06-05;10;Thursday
21308;Bara - Henri Farman;46;36;10;12;2025-06-05 10:03:33;2025-06-05;10;Thursday
19037;Belleville - Porte des Lilas;1;1;0;28;2025-06-05 09:55:45;2025-06-05;9;Thursday
6103;Mézières - Rennes;7;6;1;46;2025-06-05 10:02:43;2025-06-05;10;Thursday
21019;Edouard Vaillant - Paul-Adolphe Souriau;19;12;7;8;2025-06-05 10:03:37;2025-06-05;10;Thursday
21105;Morice - Général Leclerc;7;7;0;15;2025-06-05 09:59:28;2025-06-05;9;Thursday
32014;Place du Cornillon - Stade de France;30;13;17;3;2025-06-05 10:03:48;2025-06-05;10;Thursday
13016;Primo Levi - Frigos;22;13;9;12;2025-06-05 10:03:38;2025-06-05;10;Thursday
13043;Dunois - Clisson;2;2;0;48;2025-06-05 09:59:11;2025-06-05;9;Thursday
8051;Batignolles - Rome;2;0;2;11;2025-06-05 10:01:47;2025-06-05;10;Thursday
2009;Filles Saint-Thomas - Place de la Bourse;56;28;28;1;2025-06-05 10:02:52;2025-06-05;10;Thursday
44102;Verdun - Adrien Damalix;8;4;4;16;2025-06-05 10:04:15;2025-06-05;10;Thursday
9023;Laffitte - Italiens;29;16;13;4;2025-06-05 10:02:51;2025-06-05;10;Thursday
14122;Colonel Monteil - Brune;2;2;0;17;2025-06-05 10:00:59;2025-06-05;10;Thursday
16123;Mahatma Gandhi;23;13;10;3;2025-06-05 10:04:34;2025-06-05;10;Thursday
15108;Lourmel - Marie Skobtsov;12;8;4;9;2025-06-05 10:03:05;2025-06-05;10;Thursday
17047;Courcelles - Pierre Demours;10;5;5;16;2025-06-05 10:03:58;2025-06-05;10;Thursday
41204;République - Danton;2;0;2;16;2025-06-05 09:50:29;2025-06-05;9;Thursday
17046;Mac-Mahon - Brey;10;6;4;15;2025-06-05 10:03:21;2025-06-05;10;Thursday
18029;Emile Blemont - Poteau;4;1;3;35;2025-06-05 10:02:00;2025-06-05;10;Thursday
21703;Square du Carrefour de l'Insurrection;1;0;1;18;2025-06-05 10:03:52;2025-06-05;10;Thursday
9031;Provence - Chaussée d'Antin;20;15;5;5;2025-06-05 10:04:03;2025-06-05;10;Thursday
20023;Pelleport - Belgrand;1;1;0;13;2025-06-05 10:04:09;2025-06-05;10;Thursday
14002;Edgar Quinet - Raspail;1;0;1;45;2025-06-05 10:01:01;2025-06-05;10;Thursday
18113;Lepic - Armée d'Orient;1;0;1;23;2025-06-05 09:59:09;2025-06-05;9;Thursday
11041;Square Saint-Ambroise;10;5;5;31;2025-06-05 10:01:49;2025-06-05;10;Thursday
35003;Gabrielle Josserand - Edouard Vaillant;3;1;2;21;2025-06-05 10:02:19;2025-06-05;10;Thursday
5121;Square René Viviani - Montebello;6;2;4;27;2025-06-05 10:04:10;2025-06-05;10;Thursday
11006;Ledru-Rollin - Place du Père Chaillet;5;3;2;30;2025-06-05 10:01:26;2025-06-05;10;Thursday
19127;Aubervilliers - Curial;4;1;3;18;2025-06-05 10:04:10;2025-06-05;10;Thursday
9026;Jean-Baptiste Pigalle - La Bruyere;1;0;1;16;2025-06-05 10:04:19;2025-06-05;10;Thursday
23007;Président Wilson - Jean Jaures;5;4;1;21;2025-06-05 10:01:43;2025-06-05;10;Thursday
32015;Gare RER de Saint-Denis;8;4;4;27;2025-06-05 10:03:03;2025-06-05;10;Thursday
16043;Place de Passy;6;0;6;9;2025-06-05 09:57:12;2025-06-05;9;Thursday
16027;Mozart - Jasmin;2;2;0;60;2025-06-05 10:01:32;2025-06-05;10;Thursday
20116;Haies - Réunion;0;0;0;22;2025-06-05 10:01:21;2025-06-05;10;Thursday
6107;Place Alphonse Deville;15;9;6;7;2025-06-05 10:04:01;2025-06-05;10;Thursday
9017;Lallier - Trudaine;3;1;2;26;2025-06-05 10:03:14;2025-06-05;10;Thursday
18008;Square Léon;3;1;2;30;2025-06-05 09:59:13;2025-06-05;9;Thursday
16112;Chernoviz - Raynouard;0;0;0;37;2025-06-05 09:56:16;2025-06-05;9;Thursday
20201;Eugène Reisz - Davout;1;1;0;18;2025-06-05 10:04:05;2025-06-05;10;Thursday
22102;Mont Valérien - Michel Salles;2;2;0;21;2025-06-05 10:00:41;2025-06-05;10;Thursday
15003;Gare Montparnasse - Vaugirard;14;4;10;51;2025-06-05 10:03:59;2025-06-05;10;Thursday
17022;Pereire - Place de Wagram;2;0;2;44;2025-06-05 09:55:16;2025-06-05;9;Thursday
1117;Pont Neuf - Rivoli;17;9;8;9;2025-06-05 10:04:17;2025-06-05;10;Thursday
13010;Place d'Italie - Vincent Auriol;3;2;1;35;2025-06-05 09:54:39;2025-06-05;9;Thursday
23903;Stade Gaston Bouillant;15;14;1;13;2025-06-05 10:04:36;2025-06-05;10;Thursday
31704;Jeanne Hornet - Girardot;1;0;1;27;2025-06-05 10:02:52;2025-06-05;10;Thursday
32603;Calmette;0;0;0;32;2025-06-05 09:55:26;2025-06-05;9;Thursday
17201;Porte Maillot - Perreire;16;12;4;33;2025-06-05 10:03:29;2025-06-05;10;Thursday
23403;Chateau;2;2;0;20;2025-06-05 09:58:34;2025-06-05;9;Thursday
4013;Vieille du Temple - Francs Bourgeois;11;4;7;18;2025-06-05 10:04:33;2025-06-05;10;Thursday
45001;Hôtel de Ville de Champigny sur Marne;19;12;7;2;2025-06-05 10:01:12;2025-06-05;10;Thursday
21024;Billancourt - Général Leclerc;5;1;4;16;2025-06-05 10:03:15;2025-06-05;10;Thursday
19023;Manin - Simon Bolivar;2;1;1;20;2025-06-05 10:04:21;2025-06-05;10;Thursday
20019;Place du Maquis du Vercors;0;0;0;29;2025-06-05 10:04:32;2025-06-05;10;Thursday
7101;Raspail - Chomel;17;10;7;31;2025-06-05 10:03:49;2025-06-05;10;Thursday
15059;Parc André Citroën;0;0;0;65;2025-06-05 09:56:35;2025-06-05;9;Thursday
17116;Reims - Porte d'Asnières;7;7;0;17;2025-06-05 10:03:50;2025-06-05;10;Thursday
4011;Hôtel de Ville - Pont-Marie;9;6;3;26;2025-06-05 10:03:26;2025-06-05;10;Thursday
21114;Gustave Eiffel - Parc des Impressionnistes;3;2;1;25;2025-06-05 10:03:11;2025-06-05;10;Thursday
17016;Brochant - Square des Batignolles;3;0;3;25;2025-06-05 10:04:24;2025-06-05;10;Thursday
15020;Mairie du 15ème;7;4;3;24;2025-06-05 10:04:27;2025-06-05;10;Thursday
13113;Vistule - Choisy;1;1;0;32;2025-06-05 09:57:08;2025-06-05;9;Thursday
20017;Saint-Blaise - Mouraud;5;1;4;18;2025-06-05 10:04:18;2025-06-05;10;Thursday
21108;Mairie de Clichy;7;5;2;37;2025-06-05 10:01:09;2025-06-05;10;Thursday
6014;Pont de Lodi - Dauphine;2;0;2;21;2025-06-05 09:58:00;2025-06-05;9;Thursday
14116;Romain Rolland;2;1;1;23;2025-06-05 10:02:55;2025-06-05;10;Thursday
7026;Place de Finlande;9;5;4;15;2025-06-05 10:02:15;2025-06-05;10;Thursday
8015;Roquépine - Malesherbes;50;34;16;3;2025-06-05 10:04:31;2025-06-05;10;Thursday
5019;Poissy - Saint-Germain;6;4;2;17;2025-06-05 10:03:16;2025-06-05;10;Thursday
11107;Faidherbe - Dahomey;30;26;4;13;2025-06-05 10:02:29;2025-06-05;10;Thursday
9113;Bleue - Trévise;3;2;1;27;2025-06-05 10:01:56;2025-06-05;10;Thursday
20103;Le Vau - Maurice Bertaux;5;4;1;20;2025-06-05 10:03:22;2025-06-05;10;Thursday
3101;Porte Saint-Martin;6;1;5;27;2025-06-05 09:59:04;2025-06-05;9;Thursday
8049;Georges V - François 1er;21;10;11;1;2025-06-05 10:02:11;2025-06-05;10;Thursday
2101;Bachaumont - Montmartre;16;13;3;16;2025-06-05 10:00:35;2025-06-05;10;Thursday
12154;Square Georges Melies;36;30;6;1;2025-06-05 10:04:13;2025-06-05;10;Thursday
22017;Charles de Gaulle - Louis Philippe;20;9;11;6;2025-06-05 10:04:26;2025-06-05;10;Thursday
19021;Mairie du 19ème;0;0;0;26;2025-06-05 10:04:34;2025-06-05;10;Thursday
13022;Butte aux Cailles - Esperance;0;0;0;33;2025-06-05 09:55:32;2025-06-05;9;Thursday
11044;Square du Bataclan;10;7;3;8;2025-06-05 10:03:11;2025-06-05;10;Thursday
16041;Versailles - Claude Terrasse;4;3;1;40;2025-06-05 10:04:26;2025-06-05;10;Thursday
8029;Place du Canada;46;29;17;12;2025-06-05 10:03:05;2025-06-05;10;Thursday
11110;Roquette - Folie Regnault;4;2;2;46;2025-06-05 10:02:45;2025-06-05;10;Thursday
16031;Vignes - Boulainvilliers;3;2;1;18;2025-06-05 10:04:21;2025-06-05;10;Thursday
12153;Terroirs de France - Lheureux;34;18;16;21;2025-06-05 10:04:17;2025-06-05;10;Thursday
14127;Odessa - Départ;5;2;3;34;2025-06-05 09:59:52;2025-06-05;9;Thursday
14016;René Coty - Parc Montsouris;1;1;0;54;2025-06-05 09:58:42;2025-06-05;9;Thursday
12033;François Truffaut - Saint Emilion;61;57;4;4;2025-06-05 10:01:30;2025-06-05;10;Thursday
18142;Jessaint - Marx Dormoy;2;0;2;26;2025-06-05 10:01:46;2025-06-05;10;Thursday
15009;Suffren - Pérignon;24;20;4;21;2025-06-05 10:02:58;2025-06-05;10;Thursday
21120;Docteur Calmette - Martre;16;12;4;13;2025-06-05 10:03:24;2025-06-05;10;Thursday
48009;République - Auguste Perret;1;1;0;28;2025-06-05 09:55:33;2025-06-05;9;Thursday
14125;Dareau - Broussais;5;3;2;19;2025-06-05 10:00:43;2025-06-05;10;Thursday
21009;Le Corbusier - Jean Jaurès;45;42;3;0;2025-06-05 10:04:35;2025-06-05;10;Thursday
31017;Jean Moulin - Paul Doumer;1;0;1;19;2025-06-05 10:03:27;2025-06-05;10;Thursday
13047;Boutroux - Porte de Vitry;42;40;2;7;2025-06-05 10:03:38;2025-06-05;10;Thursday
22403;Pierre Brossolette - Adolphe Pinard;2;1;1;21;2025-06-05 10:03:58;2025-06-05;10;Thursday
20047;Cours de Vincennes - Davout;23;9;14;23;2025-06-05 09:59:53;2025-06-05;9;Thursday
22103;Senard - Charles Blum;5;3;2;16;2025-06-05 10:04:04;2025-06-05;10;Thursday
10039;Sambre et Meuse - Villette;2;1;1;20;2025-06-05 09:57:28;2025-06-05;9;Thursday
31101;Jules Guesde - Laennec;6;0;6;13;2025-06-05 10:00:25;2025-06-05;10;Thursday
31026;Demi-Lune - Aristide Briand;0;0;0;19;2025-06-05 10:00:42;2025-06-05;10;Thursday
17001;Guy Môquet - Saint-Ouen;6;2;4;46;2025-06-05 10:04:15;2025-06-05;10;Thursday
12129;Bois de Vincennes - Porte Jaune;5;5;0;29;2025-06-05 10:02:31;2025-06-05;10;Thursday
8011;Clapeyron - Moscou;2;1;1;13;2025-06-05 10:02:37;2025-06-05;10;Thursday
13020;Paul Klee - Place Augusta Holmes;37;15;22;5;2025-06-05 10:04:23;2025-06-05;10;Thursday
7010;Constantine - Université;39;13;26;25;2025-06-05 10:01:58;2025-06-05;10;Thursday
14113;Santé - Arago;6;4;2;31;2025-06-05 10:00:47;2025-06-05;10;Thursday
20203;Evariste Galois;0;0;0;16;2025-06-05 10:02:58;2025-06-05;10;Thursday
11031;Jacquard - Ternaux;5;3;2;33;2025-06-05 10:03:50;2025-06-05;10;Thursday
15125;Parc Suzanne Lenglen;34;32;2;15;2025-06-05 10:04:21;2025-06-05;10;Thursday
13027;Mazagran - Pierre de Coubertin;2;0;2;13;2025-06-05 09:56:26;2025-06-05;9;Thursday
10004;Metz - Faubourg Saint-Denis;8;5;3;38;2025-06-05 10:03:53;2025-06-05;10;Thursday
11103;Pelée - Alphonse Baudin;18;16;2;19;2025-06-05 10:03:29;2025-06-05;10;Thursday
21203;Place Jules Ferry;4;0;4;24;2025-06-05 10:04:27;2025-06-05;10;Thursday
5034;Censier - Santeuil;10;4;6;59;2025-06-05 10:04:07;2025-06-05;10;Thursday
10017;Gare de l'Est - Fidélité;6;1;5;9;2025-06-05 10:02:55;2025-06-05;10;Thursday
21316;Cimetière d'Issy-les-Moulineaux;2;0;2;22;2025-06-05 10:00:51;2025-06-05;10;Thursday
15072;Place Fernand Forest;28;23;5;5;2025-06-05 10:03:02;2025-06-05;10;Thursday
12006;Gare de Lyon - Van Gogh;35;35;0;6;2025-06-05 10:03:25;2025-06-05;10;Thursday
16014;Eylau - Trocadéro;6;2;4;16;2025-06-05 10:03:13;2025-06-05;10;Thursday
22013;Mairie de Neuilly sur Seine;11;4;7;18;2025-06-05 10:04:01;2025-06-05;10;Thursday
10110;Louis Blanc - Jemmapes;5;2;3;23;2025-06-05 10:03:41;2025-06-05;10;Thursday
21115;Chancé Milly - Cimetière Communal Sud;1;1;0;30;2025-06-05 10:01:04;2025-06-05;10;Thursday
21708;Marcel Yol - Jullien;2;0;2;28;2025-06-05 10:02:04;2025-06-05;10;Thursday
41210;Hôtel de ville de Fontenay-sous-Bois;4;0;4;15;2025-06-05 10:03:31;2025-06-05;10;Thursday
21702;Gare SNCF Vanves-Malakoff;2;0;2;47;2025-06-05 10:03:15;2025-06-05;10;Thursday
44002;Paul Vaillant-Couturier - Gare RER;20;15;5;5;2025-06-05 10:01:45;2025-06-05;10;Thursday
15123;Commerce - Letellier;24;21;3;20;2025-06-05 10:04:04;2025-06-05;10;Thursday
21031;Cimetière de Boulogne-Billancourt;32;22;10;6;2025-06-05 10:03:40;2025-06-05;10;Thursday
15043;Brancion - Lefebvre;1;0;1;10;2025-06-05 10:04:16;2025-06-05;10;Thursday
17039;Place Saint-Ferdinand;7;5;2;31;2025-06-05 10:04:32;2025-06-05;10;Thursday
20009;Docteurs Déjérine - Pte de Montreuil;8;6;2;12;2025-06-05 10:03:32;2025-06-05;10;Thursday
42305;Vanne - Saussaies;15;9;6;4;2025-06-05 10:03:10;2025-06-05;10;Thursday
11032;Jean-Pierre Timbaud - Vaucouleurs;2;1;1;42;2025-06-05 10:02:43;2025-06-05;10;Thursday
16101;Malakoff - Place de la Porte Maillot;11;7;4;15;2025-06-05 10:03:54;2025-06-05;10;Thursday
13121;Bruneseau - Quai d'Ivry;46;42;4;0;2025-06-05 10:02:39;2025-06-05;10;Thursday
10012;Vinaigriers - Magenta;2;2;0;23;2025-06-05 10:03:56;2025-06-05;10;Thursday
21028;Pierre Lefaucheux - Traversière;19;18;1;16;2025-06-05 10:02:23;2025-06-05;10;Thursday
10018;Square Alban Satragne;3;2;1;27;2025-06-05 10:02:39;2025-06-05;10;Thursday
20108;Jardin de l'Hospice Debrousse;0;0;0;23;2025-06-05 09:57:01;2025-06-05;9;Thursday
4001;Arcole - Notre-Dame;12;11;1;19;2025-06-05 10:02:14;2025-06-05;10;Thursday
23902;Gallieni - Lycée Charles Petitet;44;28;16;1;2025-06-05 10:04:29;2025-06-05;10;Thursday
13033;Porte d'Italie;3;1;2;9;2025-06-05 09:59:19;2025-06-05;9;Thursday
42701;Charles Gide - Fort de Bicêtre;1;0;1;29;2025-06-05 10:02:34;2025-06-05;10;Thursday
20122;Vitruve - Davout;2;1;1;21;2025-06-05 09:55:59;2025-06-05;9;Thursday
17015;Place de Lévis;3;2;1;43;2025-06-05 09:58:15;2025-06-05;9;Thursday
22501;Théâtre de La Garenne;9;9;0;11;2025-06-05 10:02:58;2025-06-05;10;Thursday
42003;Place de l'Insurrection d'Août 1944;28;25;3;1;2025-06-05 09:59:52;2025-06-05;9;Thursday
13011;Hôpital - Campo-Formio;3;1;2;8;2025-06-05 10:00:09;2025-06-05;10;Thursday
12043;Daumesnil - Hébrard;13;12;1;27;2025-06-05 10:02:45;2025-06-05;10;Thursday
4002;Marché aux fleurs;23;21;2;0;2025-06-05 10:03:23;2025-06-05;10;Thursday
10105;Mazagran - Bonne Nouvelle;4;3;1;20;2025-06-05 10:01:54;2025-06-05;10;Thursday
42501;Raspail - Albert Schweitzer;25;21;4;3;2025-06-05 10:03:09;2025-06-05;10;Thursday
6008;Assas - Luxembourg;10;9;1;23;2025-06-05 10:04:04;2025-06-05;10;Thursday
21204;Estienne d'Orves - Henri Ginoux;2;1;1;29;2025-06-05 09:55:39;2025-06-05;9;Thursday
42209;Place de l'Europe - Quai de Bercy;8;6;2;9;2025-06-05 10:04:35;2025-06-05;10;Thursday
22206;Louis Pasteur - Albert Petit;5;2;3;26;2025-06-05 10:04:30;2025-06-05;10;Thursday
11021;Charonne - Pierre Bayle;1;0;1;22;2025-06-05 10:03:52;2025-06-05;10;Thursday
21217;Louis Rolland - République;2;0;2;22;2025-06-05 10:01:29;2025-06-05;10;Thursday
15030;Emeriau - Beaugrenelle;69;61;8;5;2025-06-05 10:02:46;2025-06-05;10;Thursday
9114;Faubourg Poissonnière - Dunkerque;3;0;3;25;2025-06-05 09:59:37;2025-06-05;9;Thursday
16011;Victor Hugo - La Pompe;6;0;6;33;2025-06-05 10:03:46;2025-06-05;10;Thursday
12007;Gare de Lyon - Chalon;42;34;8;2;2025-06-05 10:02:49;2025-06-05;10;Thursday
35007;Benjamin Delessert - Jean Lolive;4;0;4;17;2025-06-05 10:03:46;2025-06-05;10;Thursday
47001;Place de la Gare;34;33;1;12;2025-06-05 10:03:35;2025-06-05;10;Thursday
44101;Place Mongolfier;35;34;1;4;2025-06-05 10:04:13;2025-06-05;10;Thursday
13032;Italie - Jardin Joan Miro;3;1;2;21;2025-06-05 10:03:04;2025-06-05;10;Thursday
10165;Gare de l'Est - Place du 11 Novembre 1918;1;0;1;38;2025-06-05 10:04:18;2025-06-05;10;Thursday
15064;Javel - André Citroën;40;36;4;3;2025-06-05 10:04:16;2025-06-05;10;Thursday
43001;Paris - Laitières;0;0;0;0;2025-06-05 10:02:44;2025-06-05;10;Thursday
92001;Mairie de quartier du Plateau - Mont-Valérien;2;1;1;18;2025-06-05 09:58:58;2025-06-05;9;Thursday
15005;Place Jacques et Thérèse Tréfouël;14;9;5;27;2025-06-05 10:04:08;2025-06-05;10;Thursday
18006;Square Louise Michel;3;0;3;33;2025-06-05 10:04:07;2025-06-05;10;Thursday
21401;Mairie de Clamart;1;0;1;27;2025-06-05 10:02:36;2025-06-05;10;Thursday
4020;Place Edmond Michelet;11;6;5;12;2025-06-05 09:56:52;2025-06-05;9;Thursday
23004;Paul Vaillant-Couturier - Victor Hugo;11;5;6;24;2025-06-05 09:59:36;2025-06-05;9;Thursday
5012;Estrapade - Ulm;5;0;5;11;2025-06-05 10:02:48;2025-06-05;10;Thursday
8037;Monceau - Malesherbes;11;2;9;26;2025-06-05 10:03:48;2025-06-05;10;Thursday
11017;Charonne - Bureau;3;0;3;42;2025-06-05 10:02:00;2025-06-05;10;Thursday
1021;Halles - Bourdonnais;3;0;3;17;2025-06-05 10:00:21;2025-06-05;10;Thursday
35006;Delizy - Louis Nadot;14;8;6;7;2025-06-05 10:00:38;2025-06-05;10;Thursday
41205;Maréchal Joffre - Verdun;1;0;1;19;2025-06-05 09:58:20;2025-06-05;9;Thursday
22015;Île de la Jatte;19;14;5;4;2025-06-05 10:04:23;2025-06-05;10;Thursday
12018;Saint-Mandé - Fabre d'Eglantine;6;1;5;28;2025-06-05 10:04:16;2025-06-05;10;Thursday
51002;Placette Grégoire Collas;17;17;0;6;2025-06-05 10:04:04;2025-06-05;10;Thursday
32601;Porte des Lilas - Faidherbe;0;0;0;39;2025-06-05 10:01:35;2025-06-05;10;Thursday
33016;Fort d'Aubervilliers;11;11;0;8;2025-06-05 10:03:07;2025-06-05;10;Thursday
12026;Place Ginette Hamelin;36;32;4;15;2025-06-05 10:04:19;2025-06-05;10;Thursday
13009;Auguste Blanqui - Corvisart;3;1;2;23;2025-06-05 10:04:32;2025-06-05;10;Thursday
27005;Gare du Stade;14;10;4;6;2025-06-05 10:01:38;2025-06-05;10;Thursday
15071;Suffren - Champ de Mars;2;0;2;20;2025-06-05 10:02:39;2025-06-05;10;Thursday
9024;Taitbout - La Fayette;38;23;15;15;2025-06-05 10:04:00;2025-06-05;10;Thursday
9102;Londres - Place d'Estienne d'Orves;9;5;4;15;2025-06-05 10:04:30;2025-06-05;10;Thursday
92006;Place Nelson Mandela;11;3;8;19;2025-06-05 10:03:21;2025-06-05;10;Thursday
5024;Place Monge;7;2;5;14;2025-06-05 10:03:43;2025-06-05;10;Thursday
12155;Rottembourg - Général Michel Bizot;7;4;3;33;2025-06-05 10:00:56;2025-06-05;10;Thursday
5115;Buffon - Jardin des Plantes;4;3;1;26;2025-06-05 10:04:10;2025-06-05;10;Thursday
41211;Louis Xavier de Ricard - Ancienne Mairie;3;2;1;31;2025-06-05 10:01:35;2025-06-05;10;Thursday
2108;Vivienne - Montmartre;32;20;12;4;2025-06-05 10:02:35;2025-06-05;10;Thursday
4019;Cloître Saint-Merri - Renard;17;12;5;13;2025-06-05 10:03:18;2025-06-05;10;Thursday
15129;Hôpital Necker;22;20;2;12;2025-06-05 10:04:29;2025-06-05;10;Thursday
51001;Gare d'Argenteuil;10;2;8;30;2025-06-05 10:03:41;2025-06-05;10;Thursday
6022;Marché Saint-Germain;9;7;2;12;2025-06-05 10:01:36;2025-06-05;10;Thursday
15006;Cherche-Midi - Hôpital Necker;2;1;1;36;2025-06-05 09:59:51;2025-06-05;9;Thursday
15036;Croix Nivert - Square Saint-Lambert;1;0;1;46;2025-03-03 09:03:43;2025-03-03;9;Monday
13018;Bruant - Vincent Auriol;19;17;2;6;2025-06-05 10:04:05;2025-06-05;10;Thursday
21303;Jean Monnet - Iles;25;22;3;8;2025-06-05 10:01:55;2025-06-05;10;Thursday
33014;Parc Eli Lotar;10;7;3;10;2025-06-05 10:00:13;2025-06-05;10;Thursday
9007;Condorcet - Turgot;2;0;2;18;2025-06-05 09:58:08;2025-06-05;9;Thursday
13052;Leredde - Tolbiac;38;32;6;6;2025-06-05 10:03:39;2025-06-05;10;Thursday
15127;Place Charles Michels;33;27;6;4;2025-06-05 10:02:15;2025-06-05;10;Thursday
33103;Jean Jaurès - Jules Jacquemin;3;1;2;20;2025-06-05 10:02:37;2025-06-05;10;Thursday
14032;Mairie du 14ème;2;0;2;30;2025-06-05 10:03:42;2025-06-05;10;Thursday
14011;Place des Droits de l'Enfant;2;1;1;37;2025-06-05 09:58:28;2025-06-05;9;Thursday
6002;Saint-Benoît - Jacob;19;15;4;4;2025-06-05 10:00:05;2025-06-05;10;Thursday
14031;Didot - Place de Moro-Giafferi;1;1;0;21;2025-06-05 09:59:21;2025-06-05;9;Thursday
20044;Davout - Volga;5;5;0;22;2025-06-05 10:04:11;2025-06-05;10;Thursday
33012;Landy - Heurtault;6;2;4;23;2025-06-05 09:58:02;2025-06-05;9;Thursday
2013;Favart - Italiens;17;4;13;0;2025-06-05 10:01:58;2025-06-05;10;Thursday
15070;Balard - Montagne de la Fage;0;0;0;36;2025-06-05 09:58:00;2025-06-05;9;Thursday
41203;Stalingrad - Rigollots;5;2;3;42;2025-06-05 10:04:32;2025-06-05;10;Thursday
40006;Université Paris Est Créteil;2;1;1;41;2025-06-05 09:58:20;2025-06-05;9;Thursday
10008;Cité Riverin - Château d'Eau;8;4;4;10;2025-06-05 09:57:00;2025-06-05;9;Thursday
16012;Flandrin - Longchamp;2;1;1;40;2025-06-05 10:04:22;2025-06-05;10;Thursday
16036;Porte Molitor;57;32;25;2;2025-06-05 10:04:33;2025-06-05;10;Thursday
10032;Claude Vellefaux - Hôpital Saint-Louis;1;0;1;30;2025-06-05 09:55:33;2025-06-05;9;Thursday
12015;Place de la Nation - Picpus;1;0;1;35;2025-06-05 10:03:39;2025-06-05;10;Thursday
14001;Edgar Quinet - Gaité;2;1;1;24;2025-06-05 10:03:16;2025-06-05;10;Thursday
26004;Gare RER les Grésillons;9;8;1;11;2025-06-05 10:04:12;2025-06-05;10;Thursday
18139;Poissonniers - Championnet;8;4;4;18;2025-06-05 10:02:32;2025-06-05;10;Thursday
15001;Gare Montparnasse - Arrivée;22;8;14;20;2025-06-05 10:00:35;2025-06-05;10;Thursday
15008;Sèvres - Lecourbe;4;2;2;55;2025-06-05 10:00:34;2025-06-05;10;Thursday
16105;Crevaux - Bugeaud;3;1;2;27;2025-06-05 10:01:14;2025-06-05;10;Thursday
3008;Perle - Vieille du Temple;29;13;16;7;2025-06-05 10:04:02;2025-06-05;10;Thursday
5015;Epée de Bois - Mouffetard;9;7;2;53;2025-06-05 10:04:26;2025-06-05;10;Thursday
15128;Cadix - Hameau;4;0;4;33;2025-06-05 10:04:28;2025-06-05;10;Thursday
1007;Turbigo - Française;7;4;3;8;2025-06-05 10:02:44;2025-06-05;10;Thursday
21309;Mairie d'Issy;29;25;4;12;2025-06-05 10:04:05;2025-06-05;10;Thursday
47003;Charentonneau - Maisons Alfort;3;3;0;17;2025-06-05 10:01:35;2025-06-05;10;Thursday
18004;Place des Abbesses;0;0;0;12;2025-06-05 10:04:31;2025-06-05;10;Thursday
16013;Mairie du 16ème;2;1;1;33;2025-06-05 10:04:00;2025-06-05;10;Thursday
20008;Pyrénées - Avron;2;1;1;29;2025-06-05 10:01:00;2025-06-05;10;Thursday
12019;Gare de Reuilly - Picpus;0;0;0;27;2025-06-05 10:03:27;2025-06-05;10;Thursday
20104;Louis Lumière.;5;4;1;17;2025-06-05 10:01:09;2025-06-05;10;Thursday
14135;Jourdan - Cité Universitaire;2;0;2;35;2025-06-05 10:00:44;2025-06-05;10;Thursday
20024;Gambetta - Père Lachaise;1;0;1;28;2025-06-05 10:04:19;2025-06-05;10;Thursday
3010;Beaubourg - Michel-le-Comte;6;0;6;10;2025-06-05 10:04:35;2025-06-05;10;Thursday
12156;Niger - Soult;10;10;0;14;2025-06-05 10:04:21;2025-06-05;10;Thursday
18140;Porte de Clignancourt - Ney;8;4;4;31;2025-06-05 10:02:51;2025-06-05;10;Thursday
16102;Pergolèse - Marbeau;3;3;0;24;2025-06-05 10:02:42;2025-06-05;10;Thursday
16037;Molitor - Michel-Ange;0;0;0;0;2018-03-20 09:09:28;2018-03-20;9;Tuesday
17019;Phalsbourg - Villiers;5;1;4;13;2025-06-05 10:03:14;2025-06-05;10;Thursday
19201;Petit - Georges Thill;5;3;2;18;2025-06-05 10:00:38;2025-06-05;10;Thursday
15132;Bargue -  Dutot;1;0;1;20;2025-06-05 10:00:32;2025-06-05;10;Thursday
20006;Pyrénées - Plaine;1;0;1;11;2025-06-05 10:02:59;2025-06-05;10;Thursday
10011;Bourse du Travail;10;7;3;5;2025-06-05 10:00:58;2025-06-05;10;Thursday
21953;Gare de Bellevue;2;0;2;14;2025-06-05 10:03:37;2025-06-05;10;Thursday
14019;Sarrette - Général Leclerc;3;0;3;19;2025-06-05 09:58:43;2025-06-05;9;Thursday
3011;Turbigo - Réaumur;18;8;10;12;2025-06-05 10:03:11;2025-06-05;10;Thursday
10006;Petites Ecuries - Faubourg Saint-Denis;24;5;19;2;2025-06-05 10:02:55;2025-06-05;10;Thursday
4103;Archives - Rivoli;19;14;5;5;2025-06-05 10:04:33;2025-06-05;10;Thursday
14103;Maine - Liancourt;3;1;2;24;2025-06-05 10:04:26;2025-06-05;10;Thursday
2015;Louis le Grand - Italiens;30;18;12;3;2025-06-05 10:04:15;2025-06-05;10;Thursday
21026;Sèvres - Général Leclerc;17;14;3;12;2025-06-05 10:04:29;2025-06-05;10;Thursday
20029;Frères Flavien - Porte des Lilas;2;0;2;20;2025-06-05 10:04:14;2025-06-05;10;Thursday
15111;Olivier de Serres - Leriche;1;1;0;23;2025-06-05 10:01:17;2025-06-05;10;Thursday
3005;Sainte-Elisabeth - Turbigo;0;0;0;33;2024-06-02 06:46:29;2024-06-02;6;Sunday
2005;Montmartre - Etienne Marcel;5;3;2;10;2025-06-05 10:03:27;2025-06-05;10;Thursday
3012;Square Emile - Chautemps;14;8;6;11;2025-06-05 10:04:10;2025-06-05;10;Thursday
23702;Hôtel de Ville de Chaville;4;3;1;16;2025-06-05 10:00:34;2025-06-05;10;Thursday
14022;Didot - Mariniers;7;3;4;28;2025-06-05 10:02:41;2025-06-05;10;Thursday
2002;Etienne Marcel - Montorgueil;4;3;1;24;2025-06-05 10:04:17;2025-06-05;10;Thursday
31001;Lagny - Auguste Blanqui;25;19;6;0;2025-06-05 10:03:58;2025-06-05;10;Thursday
21507;Gardenat-Lapostol - Velettes;2;0;2;18;2025-06-05 09:57:06;2025-06-05;9;Thursday
14023;Adolphe Pinard - Victor Hugo;1;0;1;51;2025-06-05 09:59:09;2025-06-05;9;Thursday
4015;Mairie du 4ème;3;2;1;41;2025-06-05 10:04:29;2025-06-05;10;Thursday
19111;Cesaria Evora - Rosa Parks;14;9;5;25;2025-06-05 10:01:32;2025-06-05;10;Thursday
9111;Victoire - Laffitte;14;13;1;6;2025-06-05 10:02:38;2025-06-05;10;Thursday
5122;Saint-Michel - Luxembourg;8;1;7;20;2025-06-05 10:02:08;2025-06-05;10;Thursday
21110;Parc Roger Salengro;24;20;4;8;2025-06-05 10:04:07;2025-06-05;10;Thursday
6031;Pierre Sarrazin - Saint-Michel;27;24;3;6;2025-06-05 10:01:05;2025-06-05;10;Thursday
4012;Tiron - Rivoli;7;4;3;21;2025-06-05 10:03:20;2025-06-05;10;Thursday
42704;Mairie du Kremlin-Bicêtre;5;3;2;20;2025-06-05 10:00:47;2025-06-05;10;Thursday
21706;Jean Bleuzen - Square du 11 Novembre;1;0;1;44;2025-06-05 10:01:59;2025-06-05;10;Thursday
1014;Rivoli - Musée du Louvre;20;12;8;2;2025-06-05 10:03:18;2025-06-05;10;Thursday
26006;Bas - Gabriel Péri;17;16;1;9;2025-06-05 10:04:09;2025-06-05;10;Thursday
42026;Barbès - Monique Maunoury;0;0;0;40;2025-06-05 10:03:06;2025-06-05;10;Thursday
13054;Pau Casals - Neuve Tolbiac;50;36;14;1;2025-06-05 10:04:30;2025-06-05;10;Thursday
2004;Square Pierre Lazareff;6;5;1;10;2025-06-05 10:00:47;2025-06-05;10;Thursday
19130;Place Paul Delouvrier;3;2;1;23;2025-06-05 10:02:33;2025-06-05;10;Thursday
21505;Édouard Vaillant - Place Jean Jaurès;0;0;0;24;2025-06-05 09:57:07;2025-06-05;9;Thursday
44001;Quai Jules Guesde - Saint-Simon;23;18;5;6;2025-06-05 10:02:30;2025-06-05;10;Thursday
4007;Place de la Bastille - Bourdon;24;20;4;11;2025-06-05 10:04:32;2025-06-05;10;Thursday
5004;Saint-Jacques - Val de Grâce;7;3;4;11;2025-06-05 10:04:00;2025-06-05;10;Thursday
4009;Village Saint-Paul;10;6;4;18;2025-06-05 10:03:26;2025-06-05;10;Thursday
10041;Gare du Nord - La Chapelle;2;0;2;14;2025-06-05 10:01:16;2025-06-05;10;Thursday
32019;Place du 8 mai 1945.;17;15;2;13;2025-06-05 10:03:48;2025-06-05;10;Thursday
9039;Chaussée d'Antin - Haussmann;27;8;19;1;2025-06-05 10:03:14;2025-06-05;10;Thursday
22506;Gare des Vallées;14;6;8;4;2025-06-05 10:04:35;2025-06-05;10;Thursday
1018;Alger - Rivoli;18;13;5;3;2025-06-05 10:04:25;2025-06-05;10;Thursday
17106;Berthier - Porte de Clichy;6;5;1;17;2025-06-05 10:01:11;2025-06-05;10;Thursday
32024;Port - Confluence;6;4;2;18;2025-06-05 10:01:42;2025-06-05;10;Thursday
6201;Saint Pères - Saint Germain;18;6;12;4;2025-06-05 10:04:22;2025-06-05;10;Thursday
6026;Saint-Placide - Cherche Midi;17;11;6;47;2025-06-05 10:04:16;2025-06-05;10;Thursday
22601;Marx Dormoy - Château Sainte-Barbe;2;2;0;20;2025-06-05 10:04:03;2025-06-05;10;Thursday
1023;Saint-Honoré - Musée du Louvre;14;12;2;17;2025-06-05 10:04:28;2025-06-05;10;Thursday
19202;Marseillaise - Grenade;0;0;0;45;2025-06-05 10:01:18;2025-06-05;10;Thursday
27001;Square Victor Basch;6;4;2;14;2025-06-05 09:55:42;2025-06-05;9;Thursday
43403;Gare RER - Canadiens;28;23;5;10;2025-06-05 10:01:20;2025-06-05;10;Thursday
3007;Archives - Pastourelle;25;19;6;3;2025-06-05 10:04:17;2025-06-05;10;Thursday
28005;Jean Jaurès - Paul Lafargue;19;14;5;6;2025-06-05 10:03:38;2025-06-05;10;Thursday
18112;Arthur Ranc - Hôpital Bichat;3;1;2;21;2025-06-05 09:56:41;2025-06-05;9;Thursday
42028;Verdun - Carnot;7;5;2;19;2025-06-05 10:02:35;2025-06-05;10;Thursday
12166;Parc Floral du Bel Air;10;6;4;14;2025-06-05 10:04:30;2025-06-05;10;Thursday
22603;Place de la Division Leclerc;2;1;1;32;2025-06-05 09:57:26;2025-06-05;9;Thursday
12113;Cardinal Lavigerie;30;27;3;14;2025-06-05 10:03:58;2025-06-05;10;Thursday
21119;Belfort - Victor Hugo;17;14;3;7;2025-06-05 10:04:32;2025-06-05;10;Thursday
42019;Lampes;24;24;0;14;2025-06-05 10:03:28;2025-06-05;10;Thursday
32022;Henri Barbusse - Marcel Cachin;0;0;0;0;2025-02-24 10:20:03;2025-02-24;10;Monday
32020;Jules Guesdes - Carnot;0;0;0;15;2025-06-05 10:04:19;2025-06-05;10;Thursday
1008;Les Halles - Saint-Eustache;9;6;3;23;2025-06-05 10:02:21;2025-06-05;10;Thursday
2006;Place des Victoires;16;13;3;8;2025-06-05 10:03:56;2025-06-05;10;Thursday
9019;Victor Massé - Jean-Baptiste Pigalle;4;1;3;13;2025-06-05 10:03:01;2025-06-05;10;Thursday
44004;Place de l'Eglise - Vitry-sur-Seine;24;23;1;4;2025-06-05 10:04:01;2025-06-05;10;Thursday
2102;Saint-Marc - Feydeau;31;11;20;4;2025-06-05 10:04:03;2025-06-05;10;Thursday
42210;Victor Hugo - Paul Eluard;21;15;6;10;2025-06-05 10:03:12;2025-06-05;10;Thursday
34013;Blanqui - Docteur Bauer;7;2;5;20;2025-06-05 09:59:31;2025-06-05;9;Thursday
23104;Quai de Sèvres - Manufacture Nationale;23;17;6;3;2025-06-05 10:01:57;2025-06-05;10;Thursday
21011;Silly - Louis Blériot;6;5;1;17;2025-06-05 10:01:12;2025-06-05;10;Thursday
20140;Paganini - Davout;5;4;1;16;2025-06-05 10:04:17;2025-06-05;10;Thursday
23303;Gare de Robinson;9;7;2;21;2025-06-05 10:02:24;2025-06-05;10;Thursday
15018;Dutot - Place Alleray;2;1;1;53;2025-06-05 10:04:30;2025-06-05;10;Thursday
26012;Jardin Modèle - Pierre Boudou;3;2;1;14;2025-06-05 09:58:50;2025-06-05;9;Thursday
20048;Bagnolet - Place Saint-Blaise;0;0;0;28;2025-06-05 10:04:07;2025-06-05;10;Thursday
13049;Vincent Auriol - Louise Weiss;18;12;6;4;2025-06-05 10:00:50;2025-06-05;10;Thursday
6015;André Mazet - Saint-André des Arts;9;3;6;46;2025-06-05 10:02:14;2025-06-05;10;Thursday
17020;Jouffroy d'Abbans - Malesherbes;3;1;2;24;2025-06-05 10:02:56;2025-06-05;10;Thursday
23206;Béranger - Félix Faure;0;0;0;27;2025-06-05 10:04:36;2025-06-05;10;Thursday
42030;Stéphanie Bouvard - Gambetta;6;4;2;23;2025-06-05 10:02:55;2025-06-05;10;Thursday
8018;Saint-Augustin;24;19;5;21;2025-06-05 10:02:02;2025-06-05;10;Thursday
24004;Paix - Verdun;0;0;0;0;2025-05-15 10:55:31;2025-05-15;10;Thursday
51008;Martyrs de Châteaubriant - Jean Grandel;21;8;13;15;2025-06-05 10:04:30;2025-06-05;10;Thursday
24101;Place Charles de Gaulle;1;0;1;22;2025-06-05 09:56:36;2025-06-05;9;Thursday
34011;Clef des Champs - Albert Dhalenne;25;23;2;1;2025-06-05 10:03:32;2025-06-05;10;Thursday
19121;Belleville -  Pré Saint-Gervais;1;0;1;20;2025-06-05 10:02:37;2025-06-05;10;Thursday
13015;Chevaleret - Louise Weiss;32;20;12;2;2025-06-05 10:04:21;2025-06-05;10;Thursday
25007;Bons Raisins - Voltaire;1;0;1;22;2025-06-05 09:54:38;2025-06-05;9;Thursday
19114;Manin - Secrétan;0;0;0;20;2025-06-05 10:04:03;2025-06-05;10;Thursday
12123;Château de Vincennes;9;5;4;43;2025-06-05 10:04:30;2025-06-05;10;Thursday
13024;Bobillot - Tolbiac;2;0;2;29;2025-06-05 10:03:06;2025-06-05;10;Thursday
19006;Mathis - Flandre;0;0;0;0;2024-09-05 10:54:01;2024-09-05;10;Thursday
23041;Général Leclerc - Bièvre;13;11;2;11;2025-06-05 10:02:00;2025-06-05;10;Thursday
24005;Edith Cavell - Volta;8;3;5;22;2025-06-05 10:03:12;2025-06-05;10;Thursday
31104;Mairie de Rosny-sous-Bois;16;5;11;13;2025-06-05 10:00:05;2025-06-05;10;Thursday
5027;Gobelins - Port-Royal;13;10;3;25;2025-06-05 10:02:57;2025-06-05;10;Thursday
15203;Porte de Versailles;15;12;3;13;2025-06-05 10:04:29;2025-06-05;10;Thursday
13116;Place du Docteur Yersin;10;8;2;38;2025-06-05 10:00:36;2025-06-05;10;Thursday
48006;Maxime Gorki - Paul Vaillant-Couturier;2;0;2;18;2025-06-05 10:01:24;2025-06-05;10;Thursday
21022;Dôme - République;22;20;2;1;2025-06-05 10:04:30;2025-06-05;10;Thursday
15041;Franquet - Labrouste;1;0;1;36;2025-06-05 10:03:59;2025-06-05;10;Thursday
20012;Buzenval - Vignoles;1;0;1;15;2025-06-05 10:01:28;2025-06-05;10;Thursday
14004;Port Royal - Hôpital Cochin;2;1;1;20;2025-06-05 10:03:43;2025-06-05;10;Thursday
42303;Place Eustache Deschamps;10;8;2;9;2025-06-05 10:03:05;2025-06-05;10;Thursday
35013;Guillaume Tell - Parc Henri Barbusse;2;0;2;17;2025-06-05 10:02:12;2025-06-05;10;Thursday
12119;Dom-Pérignon - Gravelle;29;27;2;20;2025-06-05 10:03:22;2025-06-05;10;Thursday
23803;Sydney Bechet - Jacques Gautier;1;0;1;19;2025-06-05 10:00:12;2025-06-05;10;Thursday
43007;Hôtel de Ville de Vincennes;8;6;2;19;2025-06-05 10:04:03;2025-06-05;10;Thursday
15050;Dominique Pado - Croix Nivert;2;1;1;19;2025-06-05 10:01:31;2025-06-05;10;Thursday
16025;Jean de la Fontaine - Boulainvilliers;7;6;1;61;2025-06-05 10:01:44;2025-06-05;10;Thursday
43004;Montreuil - République;7;4;3;16;2025-06-05 10:04:12;2025-06-05;10;Thursday
14009;Tombe Issoire - René Coty;4;2;2;32;2025-06-05 10:01:54;2025-06-05;10;Thursday
18021;Marcadet - Ramey;3;0;3;36;2025-06-05 09:59:53;2025-06-05;9;Thursday
16116;George Sand - Jean de La Fontaine;1;0;1;28;2025-06-05 09:59:38;2025-06-05;9;Thursday
15045;Porte de la Plaine;1;1;0;34;2025-06-05 09:56:09;2025-06-05;9;Thursday
25004;Marcel Pourtout - Édouard Manet;5;4;1;15;2025-06-05 10:03:16;2025-06-05;10;Thursday
12022;Sahel - Général Michel Bizot;15;8;7;30;2025-06-03 22:03:29;2025-06-03;22;Tuesday
42205;Place Aristide Briand;6;6;0;26;2025-06-05 10:02:44;2025-06-05;10;Thursday
22701;Général Leclerc - République;19;19;0;11;2025-06-05 10:03:07;2025-06-05;10;Thursday
30004;Jean Jaurès - Place de la Libération;18;9;9;10;2025-06-05 09:59:53;2025-06-05;9;Thursday
20110;Gambetta - Tourelles;0;0;0;20;2025-06-05 09:57:21;2025-06-05;9;Thursday
14005;René Coty - Place Denfert-Rochereau;0;0;0;36;2025-06-05 09:57:41;2025-06-05;9;Thursday
21218;Gabriel Péri - Place de la Libération;6;6;0;11;2025-06-05 10:03:42;2025-06-05;10;Thursday
20005;Reynaldo Hahn - Lagny;9;6;3;9;2025-06-05 10:00:56;2025-06-05;10;Thursday
11016;Philippe-Auguste;5;5;0;42;2025-06-05 09:56:55;2025-06-05;9;Thursday
15120;Colonel Pierre Avia;24;22;2;4;2025-06-05 10:02:11;2025-06-05;10;Thursday
24007;Jean-Baptiste Charcot - Sainte-Geneviève;14;12;2;6;2025-06-05 10:03:06;2025-06-05;10;Thursday
6004;Regard - Rennes;17;8;9;29;2025-06-05 10:03:33;2025-06-05;10;Thursday
15114;Pasteur - Cotentin;1;1;0;8;2025-06-05 09:59:21;2025-06-05;9;Thursday
11029;Ménilmontant - Oberkampf;11;3;8;28;2025-06-05 09:54:38;2025-06-05;9;Thursday
13055;M.- A. Lagroua Weill-Hallé -  F. Dolto;44;26;18;15;2025-06-05 10:02:51;2025-06-05;10;Thursday
21027;Fief - République;17;17;0;8;2025-06-05 10:04:10;2025-06-05;10;Thursday
25002;Hôtel de Ville de Rueil-Malmaison;12;9;3;7;2025-06-05 10:01:43;2025-06-05;10;Thursday
15113;Arsonval - Falguière;5;0;5;19;2025-06-05 10:04:18;2025-06-05;10;Thursday
20011;Pyrénées - Dagorno;0;0;0;19;2025-06-05 10:02:12;2025-06-05;10;Thursday
19001;Crimée - Ourcq;3;2;1;53;2025-06-05 10:04:19;2025-06-05;10;Thursday
20106;Mairie du 20ème;1;1;0;26;2025-06-05 10:00:37;2025-06-05;10;Thursday
21007;Rond-Point Rhin et Danube;51;50;1;0;2025-06-05 10:03:39;2025-06-05;10;Thursday
21016;Point du Jour - Jean Jaurès;24;23;1;16;2025-06-05 10:03:13;2025-06-05;10;Thursday
5105;Geoffroy-Saint-Hilaire - Saint-Marcel;11;11;0;6;2025-06-05 10:04:22;2025-06-05;10;Thursday
11018;Saint-Maur - République;3;3;0;33;2025-06-05 10:04:00;2025-06-05;10;Thursday
19123;Metz - Marne;4;0;4;26;2025-06-05 10:02:33;2025-06-05;10;Thursday
21107;Bertrand Sincholle - Henri Barbusse;1;1;0;20;2025-06-05 10:02:13;2025-06-05;10;Thursday
13037;Ivry - Baudricourt;2;1;1;18;2025-06-05 09:56:19;2025-06-05;9;Thursday
5031;Lacépède - Linné;7;6;1;46;2025-06-05 10:03:56;2025-06-05;10;Thursday
12017;Saint-Mandé - Docteur Arnold Netter;11;10;1;42;2025-06-05 10:00:34;2025-06-05;10;Thursday
14025;Jacquier - Didot;2;1;1;28;2025-06-05 09:58:31;2025-06-05;9;Thursday
6009;Guynemer - Jardin du Luxembourg;7;5;2;29;2025-06-05 10:03:15;2025-06-05;10;Thursday
42027;Verdun - Pierre et Marie Curie;3;0;3;23;2025-06-05 10:03:20;2025-06-05;10;Thursday
16104;Paul Valery - Victor Hugo;16;3;13;19;2025-06-05 09:59:06;2025-06-05;9;Thursday
20033;Etienne Dolet - Place Maurice Chevalier;2;1;1;44;2025-06-05 10:02:40;2025-06-05;10;Thursday
30007;Pablo Picasso - Maurice Thorez;0;0;0;0;2025-06-05 09:57:40;2025-06-05;9;Thursday
13013;Saint-Marcel - Hôpital;7;5;2;14;2025-06-05 10:01:28;2025-06-05;10;Thursday
8044;Alfred de Vigny - Place du Général Brocard;18;12;6;15;2025-06-05 10:03:51;2025-06-05;10;Thursday
1201;Perrault - Place du Louvre;9;3;6;17;2025-06-05 10:02:47;2025-06-05;10;Thursday
51007;Résistance - Romain Rolland;3;2;1;25;2025-06-05 10:04:07;2025-06-05;10;Thursday
17036;Place Tristan Bernard;7;4;3;21;2025-06-05 10:03:36;2025-06-05;10;Thursday
11040;Temple - Jean-Pierre Timbaud;5;1;4;31;2025-06-05 10:01:45;2025-06-05;10;Thursday
13008;Place d'Italie - Soeur Rosalie;0;0;0;50;2025-06-05 10:04:18;2025-06-05;10;Thursday
11038;Temple - Charlot;5;2;3;39;2025-06-05 09:56:08;2025-06-05;9;Thursday
21033;Sèvres - Maréchal Juin;10;9;1;7;2025-06-05 10:04:24;2025-06-05;10;Thursday
21112;Claude Debussy - Marc Bloch;43;40;3;11;2025-06-05 10:03:37;2025-06-05;10;Thursday
22703;Place Jean Mermoz;13;6;7;17;2025-06-05 09:58:11;2025-06-05;9;Thursday
8031;Jean Mermoz - Champs-Elysées;44;25;19;5;2025-06-05 10:03:59;2025-06-05;10;Thursday
20030;Ménilmontant - Père Lachaise;3;0;3;33;2025-06-05 10:03:58;2025-06-05;10;Thursday
16140;Hippodrome de Longchamp;21;20;1;8;2025-06-05 10:03:24;2025-06-05;10;Thursday
20035;Pyrénées - Ménilmontant;2;0;2;24;2025-06-05 10:01:04;2025-06-05;10;Thursday
23106;Pavé des Gardes - Charles Vaillant;6;6;0;13;2025-06-05 09:59:59;2025-06-05;9;Thursday
20037;Gambetta - Saint Fargeau;1;0;1;22;2025-06-05 10:04:34;2025-06-05;10;Thursday
22302;Gare RER - Général de Gaulle;36;15;21;4;2025-06-05 10:04:22;2025-06-05;10;Thursday
34009;Dora Maar - Nadia Guendouz;15;14;1;13;2025-06-05 10:02:57;2025-06-05;10;Thursday
41304;Port - Maurice Chevalier;16;15;1;14;2025-06-05 10:03:03;2025-06-05;10;Thursday
10151;Gare du Nord - Faubourg Saint-Denis;4;1;3;23;2025-06-05 10:03:02;2025-06-05;10;Thursday
7007;Musée d'Orsay;27;21;6;37;2025-06-05 10:02:53;2025-06-05;10;Thursday
22208;Stalingrad - Barbara;2;1;1;18;2025-06-05 09:59:26;2025-06-05;9;Thursday
35021;Cartier Bresson - Denis Papin;12;10;2;18;2025-06-05 10:04:03;2025-06-05;10;Thursday
18045;Pierre Ginier - Clichy;2;0;2;13;2025-06-05 10:03:59;2025-06-05;10;Thursday
32305;Saint-Germain - Verdun;1;1;0;28;2025-06-05 10:03:01;2025-06-05;10;Thursday
21954;Val-Fleury;0;0;0;22;2025-06-05 10:04:12;2025-06-05;10;Thursday
22507;Châteaudun - Place de la Liberté;12;8;4;14;2025-06-05 10:03:58;2025-06-05;10;Thursday
12165;Champs de Manoeuvre - Cartoucherie;27;11;16;7;2025-06-05 10:04:20;2025-06-05;10;Thursday
12001;Bastille - Biscornet;29;25;4;33;2025-06-05 10:03:09;2025-06-05;10;Thursday
22018;Charles de Gaulle - Les Sablons;18;10;8;16;2025-06-05 09:59:12;2025-06-05;9;Thursday
21320;Président Roosevelt - Rouget de Lisle;39;29;10;1;2025-06-05 10:04:36;2025-06-05;10;Thursday
11001;Richard Lenoir - Place de la Bastille;48;41;7;4;2025-06-05 10:03:00;2025-06-05;10;Thursday
9035;Gare Saint-Lazare - Place de Budapest;1;0;1;42;2025-06-05 10:04:36;2025-06-05;10;Thursday
34012;Bateliers - Quai de Seine;18;15;3;7;2025-06-05 10:04:14;2025-06-05;10;Thursday
23204;Roland Garros - Jean Bouin;1;0;1;27;2025-06-05 10:02:14;2025-06-05;10;Thursday
31301;Gare RER;17;6;11;11;2025-06-05 09:58:12;2025-06-05;9;Thursday
31303;Simone Signoret - Paris;16;8;8;10;2025-06-05 10:00:14;2025-06-05;10;Thursday
10026;Gare de l'Est - Chateau Landon;2;0;2;52;2025-06-05 10:02:36;2025-06-05;10;Thursday
17010;Jonquière - Docteur Paul Brousse;5;1;4;33;2025-06-05 10:02:50;2025-06-05;10;Thursday
18023;Ordener - Poissonniers;1;1;0;32;2025-06-05 10:02:45;2025-06-05;10;Thursday
18026;Ruisseau - Ordener;1;0;1;32;2025-06-05 10:00:18;2025-06-05;10;Thursday
18024;Clignancourt - Ordener;2;0;2;33;2025-06-05 10:04:34;2025-06-05;10;Thursday
8008;Joseph Sansboeuf - Saint Lazare;13;12;1;18;2025-06-05 10:00:57;2025-06-05;10;Thursday
13205;Choisy - Pointe d'Ivry;0;0;0;24;2025-06-05 09:59:16;2025-06-05;9;Thursday
31202;Gabriel Péri - Jules Ferry;20;13;7;4;2025-06-05 09:57:33;2025-06-05;9;Thursday
13204;Tolbiac - Boussingault;1;0;1;39;2025-06-05 09:58:44;2025-06-05;9;Thursday
10114;Granges aux Belles - Hôpital Saint-Louis;4;1;3;56;2025-06-05 09:58:03;2025-06-05;9;Thursday
18134;Ney - Porte de Clignancourt;3;1;2;22;2025-06-05 10:01:14;2025-06-05;10;Thursday
47007;Liberté - Vert-de-Maisons;16;14;2;0;2025-06-05 10:04:11;2025-06-05;10;Thursday
13051;Halle Freyssinet - Parvis Alan Turing;20;12;8;3;2025-06-05 10:02:07;2025-06-05;10;Thursday
8038;François 1er - Montaigne;48;29;19;4;2025-06-05 10:03:10;2025-06-05;10;Thursday
18042;Place Pigalle;4;1;3;15;2025-06-05 10:02:46;2025-06-05;10;Thursday
18041;Rochechouart - Martyrs;2;0;2;15;2025-06-05 10:03:22;2025-06-05;10;Thursday
35002;Jean Jaurès - Presles;14;10;4;17;2025-06-05 09:57:03;2025-06-05;9;Thursday
11020;Belfort - Voltaire;5;2;3;33;2025-06-05 10:04:08;2025-06-05;10;Thursday
11102;Alexandre Dumas - Voltaire;6;6;0;51;2025-06-05 10:00:38;2025-06-05;10;Thursday
16103;Traktir - Foch;1;0;1;21;2025-06-05 10:04:20;2025-06-05;10;Thursday
11009;Boulets - Voltaire;8;2;6;16;2025-06-05 09:57:37;2025-06-05;9;Thursday
40012;Stade de la Habette;5;0;5;3;2025-06-05 09:58:43;2025-06-05;9;Thursday
40014;Créteil Pointe du Lac;22;10;12;7;2025-06-05 09:58:53;2025-06-05;9;Thursday
16005;Raymond Poincaré - Place Victor Hugo;7;1;6;17;2025-06-05 10:04:15;2025-06-05;10;Thursday
26005;Hôtel de Ville d'Asnières sur Seine;5;4;1;23;2025-06-05 10:00:54;2025-06-05;10;Thursday
23801;Place de la Gare;0;0;0;18;2025-06-05 09:59:24;2025-06-05;9;Thursday
22504;Château - République;0;0;0;0;2024-07-30 07:44:13;2024-07-30;7;Tuesday
40008;Créteil Pompadour;27;8;19;16;2025-06-05 10:04:32;2025-06-05;10;Thursday
14021;Place de la Porte de Châtillon;3;3;0;56;2025-06-05 10:01:22;2025-06-05;10;Thursday
40015;Iles de Loisirs de Créteil;16;5;11;10;2025-06-05 10:04:24;2025-06-05;10;Thursday
51005;Yves Farges - Route d'Enghien;17;2;15;17;2025-06-05 10:02:11;2025-06-05;10;Thursday
10031;Louis Blanc - Aqueduc;1;1;0;36;2025-06-05 10:00:20;2025-06-05;10;Thursday
32004;Wilson - Landy;14;13;1;24;2025-06-05 10:03:23;2025-06-05;10;Thursday
10013;Alibert - Jemmapes;11;7;4;44;2025-06-05 10:01:39;2025-06-05;10;Thursday
15103;Cauchy - Cévennes;45;44;1;6;2025-06-05 10:04:30;2025-06-05;10;Thursday
15026;Bir Hakeim;23;20;3;10;2025-06-05 10:04:31;2025-06-05;10;Thursday
1022;Danielle Casanova - Place Vendôme;33;18;15;4;2025-06-05 10:02:55;2025-06-05;10;Thursday
41301;Bois de Vincennes - Gare;16;8;8;34;2025-06-05 10:03:10;2025-06-05;10;Thursday
19203;Pailleron - Bouret;2;1;1;22;2025-06-05 10:02:53;2025-06-05;10;Thursday
27004;Gare de la Garenne-Colombes;20;15;5;7;2025-06-05 10:04:12;2025-06-05;10;Thursday
1002;Victoria - Place du Chatelet;10;9;1;10;2025-06-05 10:04:25;2025-06-05;10;Thursday
17038;Grande Armée - Brunel;25;14;11;35;2025-06-05 10:03:10;2025-06-05;10;Thursday
19018;Cité de la Musique;14;7;7;44;2025-06-05 10:03:34;2025-06-05;10;Thursday
32001;Proudhon - Président Wilson;11;6;5;17;2025-06-05 10:02:54;2025-06-05;10;Thursday
13123;BNF - Bibliothèque Nationale de France;26;18;8;11;2025-06-05 10:03:00;2025-06-05;10;Thursday
40002;Bleuets - Bordières;7;4;3;14;2025-06-05 10:04:33;2025-06-05;10;Thursday
21021;Enfants du Paradis - Peupliers;61;39;22;4;2025-06-05 10:04:04;2025-06-05;10;Thursday
4104;Sebastopol - Rambuteau;3;2;1;13;2025-06-05 10:03:37;2025-06-05;10;Thursday
32012;Carrefour Pleyel;45;26;19;22;2025-06-05 10:03:50;2025-06-05;10;Thursday
12010;Daumesnil - Picpus;10;5;5;12;2025-06-05 10:04:32;2025-06-05;10;Thursday
21302;Aristide Briand - Place de la Résistance;15;11;4;13;2025-06-05 10:04:28;2025-06-05;10;Thursday
42004;Westermeyer - Paul Vaillant-Couturier;33;27;6;5;2025-06-05 10:03:28;2025-06-05;10;Thursday
15058;Place du Moulin de Javel;49;38;11;7;2025-06-05 10:03:47;2025-06-05;10;Thursday
12615;Welovegreen;0;0;0;599;2025-06-04 12:41:45;2025-06-04;12;Wednesday
1003;Saint-Denis - Rivoli;8;4;4;35;2025-06-05 10:00:39;2025-06-05;10;Thursday
8002;Gare Saint-Lazare - Cour du Havre;16;3;13;27;2025-06-05 10:04:29;2025-06-05;10;Thursday
4005;Quai des Célestins - Henri IV;0;0;0;0;2018-10-16 04:53:12;2018-10-16;4;Tuesday
8004;Malesherbes - Place de la Madeleine;62;32;30;6;2025-06-05 10:04:35;2025-06-05;10;Thursday
12105;Bercy - Villot;25;23;2;8;2025-06-05 10:03:21;2025-06-05;10;Thursday
9020;Toudouze - Clauzel;4;0;4;17;2025-06-05 09:59:10;2025-06-05;9;Thursday
14111;Cassini - Denfert-Rochereau;2;0;2;22;2025-06-05 10:02:24;2025-06-05;10;Thursday
8026;Messine - Place Du Pérou;6;2;4;6;2025-06-05 09:56:03;2025-06-05;9;Thursday
13007;Le Brun - Gobelins;8;8;0;38;2025-06-05 10:01:13;2025-06-05;10;Thursday
6003;Saint-Sulpice;5;2;3;14;2025-06-05 10:01:44;2025-06-05;10;Thursday
6108;Saint-Romain - Cherche-Midi;9;5;4;8;2025-06-05 10:02:58;2025-06-05;10;Thursday
42016;Pierre et Marie Curie - Maurice Thorez;1;0;1;26;2025-06-05 10:02:53;2025-06-05;10;Thursday
21010;Silly - Galliéni;22;15;7;2;2025-06-05 10:02:58;2025-06-05;10;Thursday
25006;Place Nelson Mandela;0;0;0;21;2025-06-05 10:01:42;2025-06-05;10;Thursday
30002;Jean Rostand - Paul Vaillant Couturier;12;3;9;23;2025-06-05 10:04:07;2025-06-05;10;Thursday
32304;Charcot - Benfleet;4;0;4;24;2025-06-05 10:01:56;2025-06-05;10;Thursday
7003;Square Boucicaut;42;18;24;17;2025-06-05 10:04:09;2025-06-05;10;Thursday
17041;Guersant - Gouvion-Saint-Cyr;8;4;4;25;2025-06-05 10:03:10;2025-06-05;10;Thursday
5016;Thouin - Cardinal Lemoine;15;3;12;1;2025-06-05 10:01:56;2025-06-05;10;Thursday
15047;Morillons - Dantzig;1;0;1;51;2025-06-05 10:02:41;2025-06-05;10;Thursday
6021;Beaux-Arts - Bonaparte;15;8;7;4;2025-06-05 10:01:47;2025-06-05;10;Thursday
15202;Bracion - Périphérique;3;1;2;26;2025-06-05 09:59:47;2025-06-05;9;Thursday
13101;Croulebarde - Corvisart;26;23;3;7;2025-06-05 10:03:59;2025-06-05;10;Thursday
14108;Le Brix et Mesmin - Jourdan;3;2;1;18;2025-06-05 10:02:40;2025-06-05;10;Thursday
2022;Saint-Fiacre - Poissonière;24;16;8;10;2025-06-05 10:02:01;2025-06-05;10;Thursday
43002;Lagny - Victor Basch;6;4;2;19;2025-06-05 10:04:26;2025-06-05;10;Thursday
92002;Théâtre des Amandiers - Palais des sports;6;1;5;17;2025-06-05 10:03:56;2025-06-05;10;Thursday
31028;Raspail Barbès;5;4;1;23;2025-06-05 09:59:29;2025-06-05;9;Thursday
16118;Michel-Ange - Parent de Rosan;7;5;2;18;2025-06-05 10:03:57;2025-06-05;10;Thursday
2017;Caire - Dussoubs;11;5;6;29;2025-06-05 10:03:06;2025-06-05;10;Thursday
8103;Artois - Berri;22;16;6;1;2025-06-05 10:01:17;2025-06-05;10;Thursday
8048;Marceau - Chaillot;18;4;14;1;2025-06-05 10:03:55;2025-06-05;10;Thursday
14013;Liard - Amiral Mouchez;5;1;4;21;2025-06-05 10:04:17;2025-06-05;10;Thursday
13118;Regnault - Patay;57;53;4;3;2025-06-05 10:04:10;2025-06-05;10;Thursday
15112;Vigée-Lebrun - Anselme Payen;2;0;2;22;2025-06-05 09:57:05;2025-06-05;9;Thursday
16110;Octave Feuillet - Albéric Magnard;8;1;7;13;2025-06-05 09:59:00;2025-06-05;9;Thursday
9001;Bellefond - Poissonnière;0;0;0;15;2025-06-05 10:04:28;2025-06-05;10;Thursday
10029;Dunkerque - Rocroy;0;0;0;23;2025-06-05 10:01:35;2025-06-05;10;Thursday
5022;Boulangers - Cardinal Lemoine;9;4;5;11;2025-06-05 09:58:56;2025-06-05;9;Thursday
21328;Verger - Colonel Guichard;1;0;1;28;2025-06-05 10:04:35;2025-06-05;10;Thursday
17040;Pereire - Ternes;1;0;1;47;2025-06-05 10:02:51;2025-06-05;10;Thursday
9038;Douai - Bruxelles;1;0;1;26;2025-06-05 10:03:31;2025-06-05;10;Thursday
8009;Gare Saint-Lazare - Isly;4;2;2;22;2025-06-05 10:01:17;2025-06-05;10;Thursday
17008;Porte Pouchet-Bessières;7;5;2;15;2025-06-05 10:04:30;2025-06-05;10;Thursday
7018;Ségur - d'Estrées;15;14;1;4;2025-06-05 09:59:29;2025-06-05;9;Thursday
5005;Gay Lussac - Saint-Jacques;9;0;9;15;2025-06-05 10:01:07;2025-06-05;10;Thursday
21323;Charlot - Stade Gabriel Voisin;30;27;3;1;2025-06-05 10:04:09;2025-06-05;10;Thursday
9106;Boudreau - Auber;18;16;2;9;2025-06-05 10:03:56;2025-06-05;10;Thursday
31706;Château - République;2;1;1;22;2025-06-05 10:03:44;2025-06-05;10;Thursday
9022;Rossini - Laffitte;28;13;15;5;2025-06-05 10:01:44;2025-06-05;10;Thursday
26003;Argenteuil - Voltaire;1;1;0;15;2025-06-05 10:02:45;2025-06-05;10;Thursday
5020;Institut du Monde Arabe - Saint-Germain;26;19;7;12;2025-06-05 10:04:01;2025-06-05;10;Thursday
92007;Pesaro - Préfecture;5;1;4;17;2025-06-05 10:01:54;2025-06-05;10;Thursday
9028;Moncey - Blanche;8;2;6;9;2025-06-05 10:03:31;2025-06-05;10;Thursday
10107;Gare du Nord - Hôpital Lariboisière;3;2;1;46;2025-06-05 10:04:28;2025-06-05;10;Thursday
26002;Redoute - Les Courtilles;23;19;4;15;2025-06-05 10:03:27;2025-06-05;10;Thursday
8034;Berri - Haussmann;33;13;20;2;2025-06-05 10:04:25;2025-06-05;10;Thursday
11047;Amelot - Saint-Sébastien;9;6;3;19;2025-06-05 10:04:06;2025-06-05;10;Thursday
19043;Delphine Seyrig - Général Leclerc;7;0;7;46;2025-06-05 10:00:07;2025-06-05;10;Thursday
18107;Chartres - La Charbonnière;0;0;0;34;2025-06-05 09:56:39;2025-06-05;9;Thursday
20042;Pyrénées - Emmery;2;0;2;37;2025-06-05 10:03:48;2025-06-05;10;Thursday
6006;Notre-Dame-des-Champs - Stanislas;3;2;1;16;2025-06-05 10:04:30;2025-06-05;10;Thursday
11027;Saint-Ambroise - Parmentier;6;3;3;31;2025-06-05 10:03:59;2025-06-05;10;Thursday
8010;Liège - Moscou;3;0;3;14;2025-06-05 10:04:11;2025-06-05;10;Thursday
10016;Récollets - Square Villemin;1;0;1;16;2025-06-05 09:58:52;2025-06-05;9;Thursday
14020;Cimetière de Montrouge;3;1;2;55;2025-06-05 10:00:17;2025-06-05;10;Thursday
15042;Henry Farman;11;6;5;5;2025-06-05 09:59:02;2025-06-05;9;Thursday
18011;Pajol - Place Herbert;0;0;0;38;2025-06-05 10:03:24;2025-06-05;10;Thursday
33102;Gabriel Péri - Francisco Ferrer;3;0;3;14;2025-06-05 10:00:55;2025-06-05;10;Thursday
42706;Roger Salengro - Fontainebleau;3;1;2;22;2025-06-05 10:02:26;2025-06-05;10;Thursday
19120;Carducci - Place Hannah Arendt;0;0;0;26;2025-06-05 10:03:32;2025-06-05;10;Thursday
18003;Cimetière de Montmartre;1;1;0;42;2025-06-05 10:00:55;2025-06-05;10;Thursday
17204;Paul Bodin - Clichy;0;0;0;33;2024-10-08 08:49:38;2024-10-08;8;Tuesday
4016;Lobau - Hôtel de Ville;8;3;5;51;2025-06-05 09:59:32;2025-06-05;9;Thursday
14138;Porte de Vanves;0;0;0;29;2025-06-05 10:03:54;2025-06-05;10;Thursday
12114;Victor Hugo - Jeanne Jugan;1;0;1;26;2025-06-05 10:02:38;2025-06-05;10;Thursday
41209;Cimetière de Fontenay-sous-Bois;2;0;2;13;2025-06-05 10:03:31;2025-06-05;10;Thursday
14008;Mouton Duvernet - Général Leclerc;2;2;0;26;2025-06-05 10:00:22;2025-06-05;10;Thursday
18028;Championnet - Vauvenargues;2;1;1;30;2025-06-05 10:04:26;2025-06-05;10;Thursday
35010;Hoche - Jean Lolive;1;1;0;23;2025-06-05 09:56:18;2025-06-05;9;Thursday
8017;Rocher - Laborde;7;5;2;58;2025-06-05 10:03:01;2025-06-05;10;Thursday
15054;Lecourbe - Jean Maridor;1;0;1;17;2025-06-05 10:01:07;2025-06-05;10;Thursday
15106;Grenelle - Violet;16;13;3;17;2025-06-05 10:00:23;2025-06-05;10;Thursday
18046;Etienne Jodelle - Saint Ouen;3;0;3;30;2025-06-05 10:02:18;2025-06-05;10;Thursday
22406;Guy Môquet - Etienne Dolet;1;0;1;21;2025-06-05 09:51:33;2025-06-05;9;Thursday
18022;Marcadet - Barbès;1;0;1;36;2025-06-05 10:02:57;2025-06-05;10;Thursday
8054;Bertie Albrecht - Hoche;15;8;7;17;2025-06-05 10:02:05;2025-06-05;10;Thursday
21005;Hôtel de Ville de Boulogne Billancourt;15;12;3;10;2025-06-05 10:03:59;2025-06-05;10;Thursday
46003;Conservatoire de Musique;0;0;0;25;2025-06-05 10:02:13;2025-06-05;10;Thursday
8045;Place de la Reine Astrid;53;32;21;3;2025-06-05 10:03:56;2025-06-05;10;Thursday
14124;David Weill - Parc Montsouris;3;2;1;18;2025-06-05 10:03:39;2025-06-05;10;Thursday
15110;Place Robert Guillemard;23;22;1;1;2025-06-05 10:04:24;2025-06-05;10;Thursday
21006;Marcelin Berthelot;23;19;4;3;2025-06-05 10:03:18;2025-06-05;10;Thursday
20131;Repos - Cimetière du Père Lachaise;0;0;0;33;2025-06-05 10:02:03;2025-06-05;10;Thursday
48010;Karl Marx;0;0;0;16;2025-06-05 09:55:26;2025-06-05;9;Thursday
41202;Gare Rer de Fontenay sous Bois;28;26;2;29;2025-06-05 10:02:12;2025-06-05;10;Thursday
25003;Henri Ste-Claire Déville - Paul Héroult;8;5;3;15;2025-06-05 09:59:19;2025-06-05;9;Thursday
6025;Assas - Rennes;4;1;3;28;2025-06-05 10:03:03;2025-06-05;10;Thursday
11026;Chemin Vert - Saint-Maur;3;2;1;41;2025-06-05 10:04:20;2025-06-05;10;Thursday
41601;Général De Gaulle - Alouette;6;6;0;19;2025-06-05 10:04:05;2025-06-05;10;Thursday
15021;Joseph Liouville - Croix Nivert;35;35;0;29;2025-06-05 09:59:43;2025-06-05;9;Thursday
9010;Rochechouart lamartine;1;1;0;22;2025-06-05 10:04:34;2025-06-05;10;Thursday
11105;Parmentier - République;0;0;0;22;2025-06-05 09:57:55;2025-06-05;9;Thursday
17125;Marie-Georges Picquart - Pereire;3;0;3;29;2025-06-05 10:04:35;2025-06-05;10;Thursday
43005;Gare RER de Vincennes;36;27;9;14;2025-06-05 10:04:32;2025-06-05;10;Thursday
16136;Théophile Gautier - François Millet;5;5;0;23;2025-06-05 09:57:47;2025-06-05;9;Thursday
19032;Villette - Belleville;9;3;6;31;2025-06-05 10:03:06;2025-06-05;10;Thursday
21701;Larmeroux - Baudelaire;0;0;0;29;2025-06-05 10:02:58;2025-06-05;10;Thursday
16008;Galilée - Kléber;10;1;9;20;2025-06-05 10:01:57;2025-06-05;10;Thursday
11024;Mairie du 11ème;3;2;1;48;2025-06-05 10:02:41;2025-06-05;10;Thursday
19022;Marché Secrétan;7;2;5;18;2025-06-05 10:01:59;2025-06-05;10;Thursday
21008;Victor Hugo - Galliéni;13;11;2;21;2025-06-05 10:03:48;2025-06-05;10;Thursday
20134;Lieutenant Chauré - Etienne Marey;1;0;1;19;2025-06-05 09:55:47;2025-06-05;9;Thursday
24001;Arche - Léonard de Vinci;14;11;3;10;2025-06-05 10:02:36;2025-06-05;10;Thursday
32302;Chemin Vert - Fraternité;1;0;1;19;2025-06-05 09:48:59;2025-06-05;9;Thursday
42010;Mairie d'Ivry-sur-Seine;40;35;5;12;2025-06-05 10:01:31;2025-06-05;10;Thursday
15046;Parc Georges Brassens - Brancion;1;0;1;27;2025-06-05 09:59:48;2025-06-05;9;Thursday
46001;Place Paul Eluard;10;8;2;8;2025-06-05 10:03:17;2025-06-05;10;Thursday
17028;Reims - Raymond Pitet;7;6;1;29;2025-06-05 10:01:28;2025-06-05;10;Thursday
19029;Seine - Flandre;1;1;0;17;2025-06-05 10:04:21;2025-06-05;10;Thursday
9032;Mathurins - Auber;16;14;2;16;2025-06-05 10:04:15;2025-06-05;10;Thursday
32003;Wilson - Métallurgie;19;15;4;8;2025-06-05 10:03:21;2025-06-05;10;Thursday
21104;Madame de Sanzillon - Mozart;16;14;2;6;2025-06-05 10:03:51;2025-06-05;10;Thursday
11042;Grand Prieuré - Crussol;14;12;2;33;2025-06-05 10:02:43;2025-06-05;10;Thursday
1013;Place du Palais Royal;44;35;9;23;2025-06-05 10:04:17;2025-06-05;10;Thursday
7102;Mairie du 7ème;38;28;10;10;2025-06-05 10:04:35;2025-06-05;10;Thursday
13002;Arago - Glacière;2;1;1;24;2025-06-05 10:03:16;2025-06-05;10;Thursday
19013;Laumière - Petit;1;1;0;33;2025-06-05 10:01:33;2025-06-05;10;Thursday
26013;Quai du docteur Dervaux;20;20;0;6;2025-06-05 10:00:58;2025-06-05;10;Thursday
20043;Charonne - Avron;2;0;2;23;2025-06-05 10:03:56;2025-06-05;10;Thursday
32016;Place de la Porte de Paris;10;7;3;23;2025-06-05 09:59:56;2025-06-05;9;Thursday
15201;Place Amédée Gordini - Lefebvre;25;5;20;13;2025-06-05 10:01:25;2025-06-05;10;Thursday
18201;Tristan Tzara -  Tchaïkovski;2;0;2;30;2025-06-05 10:01:56;2025-06-05;10;Thursday
41402;Victor Hugo - Ecoles;1;1;0;23;2025-06-05 10:04:26;2025-06-05;10;Thursday
14036;Boulard - Daguerre;1;0;1;43;2025-06-05 09:57:41;2025-06-05;9;Thursday
12009;Charenton - Diderot;4;2;2;13;2025-06-05 10:03:17;2025-06-05;10;Thursday
19205;Simon Bolivar - Henri Turot;1;0;1;22;2025-06-05 09:55:42;2025-06-05;9;Thursday
9021;Saint Georges - d'Aumale;3;1;2;20;2025-06-05 10:02:51;2025-06-05;10;Thursday
23009;Anatole France - Louise Michel;2;2;0;47;2025-06-05 10:03:17;2025-06-05;10;Thursday
12027;Montgallet - Charenton;2;0;2;14;2025-06-05 10:00:52;2025-06-05;10;Thursday
42029;Stalingrad - Germaine Tailleferre;14;12;2;13;2025-06-05 10:02:26;2025-06-05;10;Thursday
8035;Bienfaisance - Place de Narvik;26;14;12;10;2025-06-05 10:04:19;2025-06-05;10;Thursday
17102;Alfred Roll - Berthier;3;0;3;25;2025-06-05 10:04:02;2025-06-05;10;Thursday
28001;Richard Wallace - Place du 8 Mai 1945;21;13;8;9;2025-06-05 10:04:32;2025-06-05;10;Thursday
16111;Faustin Hélie - Desbordes-Valmore;2;1;1;31;2025-06-05 09:56:41;2025-06-05;9;Thursday
18110;Departement - Pajol;3;1;2;17;2025-06-05 10:01:49;2025-06-05;10;Thursday
19005;Flandre - Riquet;0;0;0;21;2025-06-05 10:00:54;2025-06-05;10;Thursday
41606;Pasteur - Gambetta;5;5;0;12;2025-06-05 10:00:43;2025-06-05;10;Thursday
43402;Place de Verdun;34;34;0;6;2025-06-05 10:02:52;2025-06-05;10;Thursday
33018;Edouard Poisson - Victor Hugo;8;8;0;21;2025-06-05 10:04:24;2025-06-05;10;Thursday
5021;Jussieu - Fossés Saint-Bernard;23;22;1;13;2025-06-05 10:04:27;2025-06-05;10;Thursday
12115;Porte de Vincennes;5;5;0;28;2025-06-05 10:03:20;2025-06-05;10;Thursday
21305;Place Jacques Madaule;23;19;4;2;2025-06-05 09:59:40;2025-06-05;9;Thursday
23001;Paul Vaillant Couturier - Chaptal;29;25;4;7;2025-06-05 10:02:29;2025-06-05;10;Thursday
15010;Square Cambronne;29;21;8;0;2025-06-05 10:01:19;2025-06-05;10;Thursday
41102;Gare de Laplace;0;0;0;43;2025-06-05 10:02:26;2025-06-05;10;Thursday
18141;Clignancourt - Sofia;2;0;2;15;2025-06-05 10:03:15;2025-06-05;10;Thursday
16124;Route de Sèvres - Porte de Bagatelle;17;14;3;45;2025-06-05 10:03:29;2025-06-05;10;Thursday
5106;Cujas - Saint-Michel;7;3;4;12;2025-06-05 10:02:45;2025-06-05;10;Thursday
22505;Mairie de La Garenne Colombes;11;9;2;9;2025-06-05 10:01:34;2025-06-05;10;Thursday
13045;Jean Colly - Tolbiac;8;4;4;26;2025-06-05 10:04:31;2025-06-05;10;Thursday
19115;Porte de la Villette;1;1;0;26;2025-06-05 10:01:17;2025-06-05;10;Thursday
16018;Flandrin - Henri Martin;1;0;1;17;2025-06-05 10:02:07;2025-06-05;10;Thursday
12034;Pirogues de Bercy - Libourne;23;13;10;25;2025-06-05 10:04:01;2025-06-05;10;Thursday
15033;Place Violet;16;10;6;14;2025-06-05 10:04:08;2025-06-05;10;Thursday
25008;Place du 8 Mai 1945;0;0;0;18;2025-06-05 10:02:20;2025-06-05;10;Thursday
19044;Grands Moulins de Pantin;20;4;16;30;2025-06-05 10:04:08;2025-06-05;10;Thursday
33001;Victor Hugo - Magasins Généraux;15;1;14;18;2025-06-05 10:02:14;2025-06-05;10;Thursday
41404;Carnot - Pâquerettes;23;19;4;2;2025-06-05 10:03:58;2025-06-05;10;Thursday
20132;Réunion - Avron;2;0;2;24;2025-06-05 10:01:07;2025-06-05;10;Thursday
92003;Chanzy - Sud-Est;11;9;2;14;2025-06-05 09:58:18;2025-06-05;9;Thursday
5119;Jussieu - Guy de la Brosse;29;25;4;10;2025-06-05 10:04:23;2025-06-05;10;Thursday
27002;Parc Pierre Lagravère;19;18;1;9;2025-06-05 10:04:24;2025-06-05;10;Thursday
31012;Place Carnot;2;0;2;21;2025-06-05 10:03:10;2025-06-05;10;Thursday
12024;Gare de Bercy;8;5;3;26;2025-06-05 10:04:04;2025-06-05;10;Thursday
16129;Ceinture du Lac Inferieure - Saint-Cloud;2;1;1;39;2025-06-05 09:58:45;2025-06-05;9;Thursday
14104;Boyer-Barret - Raymond Losserand;1;1;0;22;2025-06-05 10:01:51;2025-06-05;10;Thursday
31705;Champeaux - Gallieni;3;1;2;47;2025-06-05 10:00:07;2025-06-05;10;Thursday
6030;Assas - Vaugirard;1;1;0;33;2025-06-05 10:03:03;2025-06-05;10;Thursday
23802;Raymond Poincaré - Allée de la Marche;6;0;6;17;2025-06-05 09:56:37;2025-06-05;9;Thursday
12126;Gravelle - Route du Bac;5;2;3;44;2025-06-05 10:00:03;2025-06-05;10;Thursday
20036;Ménilmontant - Pelleport;0;0;0;32;2025-06-05 09:56:16;2025-06-05;9;Thursday
41604;Lagny - Joffre;19;14;5;9;2025-06-05 10:04:02;2025-06-05;10;Thursday
15029;Emeriau - Place de Brazzaville;44;43;1;5;2025-06-05 10:03:36;2025-06-05;10;Thursday
10005;Petites Ecuries - Faubourg Poissonnière;5;3;2;12;2025-06-05 10:03:58;2025-06-05;10;Thursday
18020;Francoeur - Marcadet;0;0;0;18;2025-06-05 10:01:27;2025-06-05;10;Thursday
43006;Vignerons - Minimes;19;15;4;10;2025-06-05 10:04:06;2025-06-05;10;Thursday
15028;Grenelle - Dr Finlay;53;46;7;17;2025-06-05 10:03:42;2025-06-05;10;Thursday
8102;Lamennais - Washington;23;10;13;2;2025-06-05 10:04:04;2025-06-05;10;Thursday
7004;Raspail - Varenne;12;11;1;6;2025-06-05 10:03:49;2025-06-05;10;Thursday
21013;Pierre Grenier - Pont de Billancourt;2;2;0;19;2025-06-05 10:03:25;2025-06-05;10;Thursday
42503;Vladimir Ilitch Lénine - Andrée Chedid;0;0;0;31;2025-06-05 10:02:24;2025-06-05;10;Thursday
11114;Ledru-Rollin - Charonne;21;15;6;10;2025-06-05 10:03:46;2025-06-05;10;Thursday
5116;Place Valhubert;17;14;3;33;2025-06-05 10:02:52;2025-06-05;10;Thursday
7014;Saint-François-Xavier;27;25;2;14;2025-06-05 10:03:45;2025-06-05;10;Thursday
20040;Parc de Belleville - Julien Lacroix;2;1;1;24;2025-06-05 10:03:26;2025-06-05;10;Thursday
17017;Gare de Pont-Cardinet;1;1;0;32;2025-06-05 09:57:15;2025-06-05;9;Thursday
10023;Gare de l'Est - Verdun;2;0;2;11;2025-06-05 10:00:02;2025-06-05;10;Thursday
23002;Pont de Levallois-bécon;31;25;6;19;2025-06-05 10:03:15;2025-06-05;10;Thursday
14139;Pierre Larousse - Raymond Losserand;3;1;2;26;2025-06-05 10:04:22;2025-06-05;10;Thursday
11101;Charles Delescluze;22;19;3;26;2025-06-05 10:03:47;2025-06-05;10;Thursday
15055;Vasco de Gama;36;34;2;18;2025-06-05 10:04:31;2025-06-05;10;Thursday
14130;Jonquoy - Didot;2;1;1;28;2025-06-05 10:01:26;2025-06-05;10;Thursday
41207;Place du Général de Gaulle;24;6;18;4;2025-06-05 10:04:12;2025-06-05;10;Thursday
12011;Charenton - Place du Col Bourgoin;20;14;6;15;2025-06-05 10:04:01;2025-06-05;10;Thursday
12032;Porte Dorée;35;28;7;1;2025-06-05 10:03:25;2025-06-05;10;Thursday
15038;Place Adolphe Cherioux - Vaugirard;9;2;7;53;2025-06-05 10:03:24;2025-06-05;10;Thursday
21032;Sèvres-Gallieni;25;18;7;2;2025-06-05 10:02:33;2025-06-05;10;Thursday
20021;Indre - Prairies;1;0;1;35;2025-06-05 10:00:07;2025-06-05;10;Thursday
7005;Raspail - Bac;33;25;8;18;2025-06-05 10:03:32;2025-06-05;10;Thursday
6018;Michelet - Assas;2;1;1;16;2025-06-05 09:58:03;2025-06-05;9;Thursday
19109;Tanger - Place du Maroc;2;1;1;17;2025-06-05 10:03:51;2025-06-05;10;Thursday
31019;Vincennes - Douy-Delcupe;4;0;4;34;2025-06-05 10:00:20;2025-06-05;10;Thursday
18032;Porte de Clignancourt.;3;0;3;52;2025-06-05 10:03:03;2025-06-05;10;Thursday
17124;Porte de Saint-Ouen - Henri Huchard;3;1;2;22;2025-06-05 10:03:51;2025-06-05;10;Thursday
44012;Génie - Mozart;0;0;0;19;2025-06-05 09:55:13;2025-06-05;9;Thursday
17027;Place du Maréchal Juin - Péreire;7;6;1;37;2025-06-05 09:55:51;2025-06-05;9;Thursday
31016;Lucie Aubrac - Franklin;6;5;1;30;2025-06-05 10:01:51;2025-06-05;10;Thursday
51003;Hôtel de Ville d'Argenteuil;21;8;13;7;2025-06-05 10:04:35;2025-06-05;10;Thursday
22101;Gare Routière de Saint Cloud;25;23;2;4;2025-06-05 10:04:16;2025-06-05;10;Thursday
9115;Milton - Manuel;1;0;1;21;2025-06-05 09:59:22;2025-06-05;9;Thursday
19039;Edouard Pailleron - Simon Bolivar;2;0;2;22;2025-06-05 09:56:07;2025-06-05;9;Thursday
16032;Eglise d'Auteuil;7;6;1;13;2025-06-05 10:00:27;2025-06-05;10;Thursday
21003;Jean Jaurès - Jean Baptiste Clément;23;16;7;13;2025-06-05 10:02:16;2025-06-05;10;Thursday
22001;Château - Bineau;7;2;5;16;2025-06-05 09:58:19;2025-06-05;9;Thursday
18025;Mairie du 18ème;1;0;1;39;2025-06-05 10:02:31;2025-06-05;10;Thursday
17122;Bridaine - Lamandé;3;1;2;26;2025-06-05 10:03:10;2025-06-05;10;Thursday
20027;Porte de Ménilmontant;1;0;1;14;2025-06-05 10:02:04;2025-06-05;10;Thursday
31007;Paris - Désiré Préaux;15;4;11;32;2025-06-05 10:03:33;2025-06-05;10;Thursday
19040;Belleville - Télégraphe;2;1;1;39;2025-06-05 10:02:08;2025-06-05;10;Thursday
6016;Danton - Serpente;11;8;3;10;2025-06-05 10:02:09;2025-06-05;10;Thursday
17121;Square des Epinettes;4;3;1;16;2025-06-05 10:01:41;2025-06-05;10;Thursday
19009;Cité des Sciences et de l'Industrie;4;0;4;21;2025-06-05 10:03:22;2025-06-05;10;Thursday
18109;Pajol - Riquet;3;1;2;44;2025-06-05 10:01:45;2025-06-05;10;Thursday
19038;Lassus - Delouvain;1;0;1;19;2025-06-05 10:02:12;2025-06-05;10;Thursday
35017;Toffier Decaux - Cartier Bresson;7;6;1;9;2025-06-05 09:58:05;2025-06-05;9;Thursday
20118;Orteaux - Mouraud;1;0;1;23;2025-06-05 10:02:25;2025-06-05;10;Thursday
16021;François Ponsard - La Muette;3;1;2;20;2025-06-05 10:03:18;2025-06-05;10;Thursday
9117;Bellefond - Maubeuge;4;0;4;26;2025-06-05 10:04:02;2025-06-05;10;Thursday
15035;Place Etienne Pernet;24;22;2;18;2025-06-05 10:04:23;2025-06-05;10;Thursday
18049;Porte d'Aubervilliers;4;2;2;49;2025-06-05 10:01:57;2025-06-05;10;Thursday
10020;Chabrol - d'Hauteville;5;0;5;6;2025-06-05 10:02:33;2025-06-05;10;Thursday
34010;Hôtel de Ville de Saint-Ouen;43;40;3;4;2025-06-05 10:02:57;2025-06-05;10;Thursday
31703;Sadi Carnot - François Mitterrand;1;0;1;26;2025-06-05 09:58:08;2025-06-05;9;Thursday
15031;Théâtre - Lourmel;26;25;1;27;2025-06-05 10:03:59;2025-06-05;10;Thursday
21014;Hameau Fleuri - Marché;18;17;1;3;2025-06-05 10:02:24;2025-06-05;10;Thursday
47005;Ecole Vétérinaire;33;31;2;2;2025-06-05 10:02:58;2025-06-05;10;Thursday
16015;Bassano -  Iéna;13;5;8;2;2025-06-05 10:03:30;2025-06-05;10;Thursday
1120;Lavandieres Sainte Opportune - Rivoli;6;2;4;21;2025-06-05 10:02:25;2025-06-05;10;Thursday
14112;Méchain - Faubourg Saint-Jacques;4;1;3;10;2025-06-05 10:04:25;2025-06-05;10;Thursday
47004;Stade Auguste Delaune;17;15;2;4;2025-06-05 10:02:01;2025-06-05;10;Thursday
21001;Transvaal - Charles de Gaulle;26;19;7;1;2025-06-05 10:02:03;2025-06-05;10;Thursday
18033;Belliard - Damrémont;0;0;0;32;2025-06-05 10:01:01;2025-06-05;10;Thursday
11010;Boulets - Faubourg Saint-Antoine;4;2;2;38;2025-06-05 10:03:10;2025-06-05;10;Thursday
16122;Route de la Muette - Porte de Neuilly;9;1;8;38;2025-06-05 10:03:34;2025-06-05;10;Thursday
15002;Maine - Antoine Bourdelle;6;1;5;11;2025-06-05 10:02:07;2025-06-05;10;Thursday
21310;Kléber - Gouverneur Général Eboué;22;20;2;2;2025-06-05 10:01:59;2025-06-05;10;Thursday
20016;Pyrénées - Maraîchers;3;2;1;30;2025-06-05 10:04:10;2025-06-05;10;Thursday
10010;Place Jacques Bonsergent;8;5;3;18;2025-06-05 10:04:14;2025-06-05;10;Thursday
16029;Maison de Radio - France;19;8;11;27;2025-06-05 10:04:27;2025-06-05;10;Thursday
8019;Naples - Rome;5;2;3;21;2025-06-05 10:03:03;2025-06-05;10;Thursday
7008;Villersexel - Saint-Germain;5;2;3;9;2025-06-05 09:56:37;2025-06-05;9;Thursday
42703;Fontainebleau - Edmond Michelet;4;2;2;41;2025-06-05 09:52:31;2025-06-05;9;Thursday
14030;Pernety - Raymond Losserand;2;0;2;29;2025-06-05 10:04:36;2025-06-05;10;Thursday
13046;Eugène Oudiné - Dessous Des Berges;38;38;0;6;2025-06-05 10:04:33;2025-06-05;10;Thursday
4110;Neuve Saint-Pierre - Beautreillis;13;11;2;7;2025-06-05 10:03:45;2025-06-05;10;Thursday
6032;Sabot - Rennes;16;7;9;10;2025-06-05 10:04:03;2025-06-05;10;Thursday
7020;Champ de Mars - Cler;13;10;3;27;2025-06-05 10:02:17;2025-06-05;10;Thursday
10036;Aqueduc - Villette;2;1;1;22;2025-06-05 10:02:54;2025-06-05;10;Thursday
23304;Mairie de Sceaux;0;0;0;32;2025-06-05 10:02:32;2025-06-05;10;Thursday
6017;Sénat - Condé;22;18;4;11;2025-06-05 10:04:14;2025-06-05;10;Thursday
12161;Diderot - Reuilly;14;6;8;29;2025-06-05 10:02:26;2025-06-05;10;Thursday
15107;Palais des Sports;17;15;2;5;2025-06-05 09:59:02;2025-06-05;9;Thursday
9101;Cadet - La Fayette;4;4;0;15;2025-06-05 10:04:31;2025-06-05;10;Thursday
18017;Caulaincourt - Place Constantin Pecqueur;1;0;1;43;2025-06-05 09:59:14;2025-06-05;9;Thursday
19041;Belleville - Pyrénées;2;0;2;38;2025-06-05 10:02:34;2025-06-05;10;Thursday
11043;Place Pasdeloup;14;9;5;6;2025-06-05 10:04:12;2025-06-05;10;Thursday
13103;Hôpital Pitié Salpêtrière;12;12;0;36;2025-06-05 10:02:52;2025-06-05;10;Thursday
31023;Place François Mitterand;1;0;1;32;2025-06-05 10:00:42;2025-06-05;10;Thursday
9118;Faubourg Poissonniere - Delta;1;0;1;35;2025-06-05 10:00:05;2025-06-05;10;Thursday
10163;Gare du Nord - Demarquay;2;1;1;28;2025-06-05 10:04:26;2025-06-05;10;Thursday
2001;Greneta - Sebastopol;3;2;1;27;2025-06-05 10:04:23;2025-06-05;10;Thursday
18137;Poissonniers - Nord;2;0;2;23;2025-06-05 10:04:15;2025-06-05;10;Thursday
18138;Station Paris Basketball - Ney - Charles Hermite;7;7;0;13;2025-06-05 09:54:38;2025-06-05;9;Thursday
13041;Porte d'Ivry;5;4;1;44;2025-06-05 10:02:21;2025-06-05;10;Thursday
7016;Surcouf - Université;7;5;2;49;2025-06-05 10:04:36;2025-06-05;10;Thursday
12041;Bois de Vincennes.;38;32;6;21;2025-06-05 10:04:12;2025-06-05;10;Thursday
12108;Bercy.;57;51;6;8;2025-06-05 10:03:56;2025-06-05;10;Thursday
14006;Saint-Jacques - Tombe Issoire;3;0;3;19;2025-06-05 10:04:13;2025-06-05;10;Thursday
7013;Duroc - Place de Breteuil;18;12;6;25;2025-06-05 10:03:23;2025-06-05;10;Thursday
8056;Beaujon - Wagram;5;3;2;24;2025-06-05 10:04:34;2025-06-05;10;Thursday
21311;Parvis Corentin Celton;50;45;5;5;2025-06-05 10:04:13;2025-06-05;10;Thursday
31013;Centenaire - Sorins;3;2;1;42;2025-06-05 10:04:15;2025-06-05;10;Thursday
32018;Franciade - Gabriel Péri;16;14;2;9;2025-06-05 10:02:02;2025-06-05;10;Thursday
20202;Dupont de l'Eure - Gambetta;1;0;1;30;2025-06-05 09:59:05;2025-06-05;9;Thursday
18019;Square Raymond Souplex;4;0;4;48;2025-06-05 10:03:10;2025-06-05;10;Thursday
11003;Keller - La Roquette;3;3;0;30;2025-06-05 10:00:44;2025-06-05;10;Thursday
